Nuclide,N,Z,A,El,Atomic Mass
n-1,1,0,1,n,1.008664.9159
H-1,0,1,1,H,1.007825.03190
H-2,1,1,2,H,2.014101.77784
H-3,2,1,3,H,3.016049.28132
He-3,1,2,3,He,3.016029.32197
Li-3,0,3,3,Li,3.030780
H-4,3,1,4,H,4.026430
He-4,2,2,4,He,4.002603.25413
Li-4,1,3,4,Li,4.027190
H-5,4,1,5,H,5.035310
He-5,3,2,5,He,5.012057
Li-5,2,3,5,Li,5.012540
Be-5,1,4,5,Be,5.039870
H-6,5,1,6,H,6.044960
He-6,4,2,6,He,6.018885.89
Li-6,3,3,6,Li,6.015122.8874
Be-6,2,4,6,Be,6.019726
B-6,1,5,6,B,6.050800
H-7,6,1,7,H,7.052750
He-7,5,2,7,He,7.027991
Li-7,4,3,7,Li,7.016003.434
Be-7,3,4,7,Be,7.016928.71
B-7,2,5,7,B,7.029712
He-8,6,2,8,He,8.033934.39
Li-8,5,3,8,Li,8.022486.24
Be-8,4,4,8,Be,8.005305.10
B-8,3,5,8,B,8.024607.3
C-8,2,6,8,C,8.037643
He-9,7,2,9,He,9.043950
Li-9,6,3,9,Li,9.026790.19
Be-9,5,4,9,Be,9.012183.06
B-9,4,5,9,B,9.013329.6
C-9,3,6,9,C,9.031037.2
He-10,8,2,10,He,10.052820
Li-10,7,3,10,Li,10.035483
Be-10,6,4,10,Be,10.013534.69
B-10,5,5,10,B,10.012936.862
C-10,4,6,10,C,10.016853.22
N-10,3,7,10,N,10.041650
Li-11,8,3,11,Li,11.043723.6
Be-11,7,4,11,Be,11.021661.08
B-11,6,5,11,B,11.009305.167
C-11,5,6,11,C,11.011432.60
N-11,4,7,11,N,11.026158
O-11,3,8,11,O,11.051250
Li-12,9,3,12,Li,12.052610
Be-12,8,4,12,Be,12.026922.1
B-12,7,5,12,B,12.014352.6
C-12,6,6,12,C,12.000000.0
N-12,5,7,12,N,12.018613.2
O-12,4,8,12,O,12.034368
Li-13,10,3,13,Li,13.061170
Be-13,9,4,13,Be,13.036135
B-13,8,5,13,B,13.017780.0
C-13,7,6,13,C,13.003354.83534
N-13,6,7,13,N,13.005738.61
O-13,5,8,13,O,13.024815
F-13,4,9,13,F,13.045120
Be-14,10,4,14,Be,14.042890
B-14,9,5,14,B,14.025404
C-14,8,6,14,C,14.003241.989
N-14,7,7,14,N,14.003074.00425
O-14,6,8,14,O,14.008596.706
F-14,5,9,14,F,14.034320
Be-15,11,4,15,Be,15.053490
B-15,10,5,15,B,15.031087
C-15,9,6,15,C,15.010599.3
N-15,8,7,15,N,15.000108.8983
O-15,7,8,15,O,15.003065.6
F-15,6,9,15,F,15.017785
Ne-15,5,10,15,Ne,15.043170
Be-16,12,4,16,Be,16.061670
B-16,11,5,16,B,16.039841
C-16,10,6,16,C,16.014701
N-16,9,7,16,N,16.006101.9
O-16,8,8,16,O,15.994914.6193
F-16,7,9,16,F,16.011460
Ne-16,6,10,16,Ne,16.025751
B-17,12,5,17,B,17.046930
C-17,11,6,17,C,17.022579
N-17,10,7,17,N,17.008449
O-17,9,8,17,O,16.999131.7560
F-17,8,9,17,F,17.002095.24
Ne-17,7,10,17,Ne,17.017714.0
Na-17,6,11,17,Na,17.037270
B-18,13,5,18,B,18.055600
C-18,12,6,18,C,18.026750
N-18,11,7,18,N,18.014078
O-18,10,8,18,O,17.999159.6121
F-18,9,9,18,F,18.000937.3
Ne-18,8,10,18,Ne,18.005708.7
Na-18,7,11,18,Na,18.026880
B-19,14,5,19,B,19.064170
C-19,13,6,19,C,19.034800
N-19,12,7,19,N,19.017022
O-19,11,8,19,O,19.003578.0
F-19,10,9,19,F,18.998403.1621
Ne-19,9,10,19,Ne,19.001880.91
Na-19,8,11,19,Na,19.013880
Mg-19,7,12,19,Mg,19.034180
B-20,15,5,20,B,20.074510
C-20,14,6,20,C,20.040260
N-20,13,7,20,N,20.023370
O-20,12,8,20,O,20.004075.4
F-20,11,9,20,F,19.999981.25
Ne-20,10,10,20,Ne,19.992440.1753
Na-20,9,11,20,Na,20.007354.3
Mg-20,8,12,20,Mg,20.018763.1
B-21,16,5,21,B,21.084150
C-21,15,6,21,C,21.049000
N-21,14,7,21,N,21.027090
O-21,13,8,21,O,21.008655
F-21,12,9,21,F,20.999948.9
Ne-21,11,10,21,Ne,20.993846.69
Na-21,10,11,21,Na,20.997654.46
Mg-21,9,12,21,Mg,21.011705.8
Al-21,8,13,21,Al,21.029080
C-22,16,6,22,C,22.057550
N-22,15,7,22,N,22.034100
O-22,14,8,22,O,22.009970
F-22,13,9,22,F,22.002999
Ne-22,12,10,22,Ne,21.991385.114
Na-22,11,11,22,Na,21.994437.55
Mg-22,10,12,22,Mg,21.999570.60
Al-22,9,13,22,Al,22.019540
Si-22,8,14,22,Si,22.036110
C-23,17,6,23,C,23.068890
N-23,16,7,23,N,23.039420
O-23,15,8,23,O,23.015700
F-23,14,9,23,F,23.003530
Ne-23,13,10,23,Ne,22.994466.91
Na-23,12,11,23,Na,22.989769.2820
Mg-23,11,12,23,Mg,22.994123.77
Al-23,10,13,23,Al,23.007244.4
Si-23,9,14,23,Si,23.025710
N-24,17,7,24,N,24.050390
O-24,16,8,24,O,24.019860
F-24,15,9,24,F,24.008100
Ne-24,14,10,24,Ne,23.993610.6
Na-24,13,11,24,Na,23.990963.012
Mg-24,12,12,24,Mg,23.985041.689
Al-24,11,13,24,Al,23.999947.60
Si-24,10,14,24,Si,24.011535
P-24,9,15,24,P,24.036520
N-25,18,7,25,N,25.060100
O-25,17,8,25,O,25.029340
F-25,16,9,25,F,25.012170
Ne-25,15,10,25,Ne,24.997810
Na-25,14,11,25,Na,24.989954.0
Mg-25,13,12,25,Mg,24.985836.97
Al-25,12,13,25,Al,24.990428.31
Si-25,11,14,25,Si,25.004109
P-25,10,15,25,P,25.021680
O-26,18,8,26,O,26.037210
F-26,17,9,26,F,26.020050
Ne-26,16,10,26,Ne,26.000516
Na-26,15,11,26,Na,25.992635
Mg-26,14,12,26,Mg,25.982592.97
Al-26,13,13,26,Al,25.986891.88
Si-26,12,14,26,Si,25.992333.82
P-26,11,15,26,P,26.011780
S-26,10,16,26,S,26.029720
O-27,19,8,27,O,27.047960
F-27,18,9,27,F,27.026980
Ne-27,17,10,27,Ne,27.007570
Na-27,16,11,27,Na,26.994076
Mg-27,15,12,27,Mg,26.984340.65
Al-27,14,13,27,Al,26.981538.41
Si-27,13,14,27,Si,26.986704.69
P-27,12,15,27,P,26.999292
S-27,11,16,27,S,27.018780
O-28,20,8,28,O,28.055910
F-28,19,9,28,F,28.035860
Ne-28,18,10,28,Ne,28.012130
Na-28,17,11,28,Na,27.998939
Mg-28,16,12,28,Mg,27.983875.43
Al-28,15,13,28,Al,27.981910.01
Si-28,14,14,28,Si,27.976926.5344
P-28,13,15,28,P,27.992326.5
S-28,12,16,28,S,28.004370
Cl-28,11,17,28,Cl,28.030350
F-29,20,9,29,F,29.043100
Ne-29,19,10,29,Ne,29.019750
Na-29,18,11,29,Na,29.002877
Mg-29,17,12,29,Mg,28.988607.2
Al-29,16,13,29,Al,28.980453.2
Si-29,15,14,29,Si,28.976494.6643
P-29,14,15,29,P,28.981800.4
S-29,13,16,29,S,28.996678
Cl-29,12,17,29,Cl,29.015050
Ar-29,11,18,29,Ar,29.040760
F-30,21,9,30,F,30.052560
Ne-30,20,10,30,Ne,30.024990
Na-30,19,11,30,Na,30.009098
Mg-30,18,12,30,Mg,29.990465.5
Al-30,17,13,30,Al,29.982969.2
Si-30,16,14,30,Si,29.973770.137
P-30,15,15,30,P,29.978313.49
S-30,14,16,30,S,29.984906.77
Cl-30,13,17,30,Cl,30.005018
Ar-30,12,18,30,Ar,30.023690
F-31,22,9,31,F,31.061020
Ne-31,21,10,31,Ne,31.033470
Na-31,20,11,31,Na,31.013147
Mg-31,19,12,31,Mg,30.996648
Al-31,18,13,31,Al,30.983949.8
Si-31,17,14,31,Si,30.975363.20
P-31,16,15,31,P,30.973761.9977
S-31,15,16,31,S,30.979557.00
Cl-31,14,17,31,Cl,30.992448
Ar-31,13,18,31,Ar,31.012160
K-31,12,19,31,K,31.036780
Ne-32,22,10,32,Ne,32.039720
Na-32,21,11,32,Na,32.020010
Mg-32,20,12,32,Mg,31.999110
Al-32,19,13,32,Al,31.988084
Si-32,18,14,32,Si,31.974151.5
P-32,17,15,32,P,31.973907.64
S-32,16,16,32,S,31.972071.1735
Cl-32,15,17,32,Cl,31.985684.6
Ar-32,14,18,32,Ar,31.997637.8
K-32,13,19,32,K,32.023610
Ne-33,23,10,33,Ne,33.049520
Na-33,22,11,33,Na,33.025530
Mg-33,21,12,33,Mg,33.005327.9
Al-33,20,13,33,Al,32.990878
Si-33,19,14,33,Si,32.977977.0
P-33,18,15,33,P,32.971725.7
S-33,17,16,33,S,32.971458.9086
Cl-33,16,17,33,Cl,32.977452.0
Ar-33,15,18,33,Ar,32.989925.5
K-33,14,19,33,K,33.008100
Ca-33,13,20,33,Ca,33.033310
Ne-34,24,10,34,Ne,34.056730
Na-34,23,11,34,Na,34.034010
Mg-34,22,12,34,Mg,34.008935
Al-34,21,13,34,Al,33.996781.9
Si-34,20,14,34,Si,33.978538.0
P-34,19,15,34,P,33.973645.9
S-34,18,16,34,S,33.967867.01
Cl-34,17,17,34,Cl,33.973762.49
Ar-34,16,18,34,Ar,33.980270.09
K-34,15,19,34,K,33.998690
Ca-34,14,20,34,Ca,34.015990
Na-35,24,11,35,Na,35.040610
Mg-35,23,12,35,Mg,35.016790
Al-35,22,13,35,Al,34.999760
Si-35,21,14,35,Si,34.984550
P-35,20,15,35,P,34.973314.0
S-35,19,16,35,S,34.969032.32
Cl-35,18,17,35,Cl,34.968852.69
Ar-35,17,18,35,Ar,34.975257.7
K-35,16,19,35,K,34.988005.4
Ca-35,15,20,35,Ca,35.005570
Sc-35,14,21,35,Sc,35.029090
Na-36,25,11,36,Na,36.049280
Mg-36,24,12,36,Mg,36.021880
Al-36,23,13,36,Al,36.006390
Si-36,22,14,36,Si,35.986650
P-36,21,15,36,P,35.978260
S-36,20,16,36,S,35.967080.69
Cl-36,19,17,36,Cl,35.968306.82
Ar-36,18,18,36,Ar,35.967545.106
K-36,17,19,36,K,35.981301.9
Ca-36,16,20,36,Ca,35.993070
Sc-36,15,21,36,Sc,36.017340
Na-37,26,11,37,Na,37.057040
Mg-37,25,12,37,Mg,37.030290
Al-37,24,13,37,Al,37.010530
Si-37,23,14,37,Si,36.992950
P-37,22,15,37,P,36.979610
S-37,21,16,37,S,36.971125.50
Cl-37,20,17,37,Cl,36.965902.57
Ar-37,19,18,37,Ar,36.966776.30
K-37,18,19,37,K,36.973375.89
Ca-37,17,20,37,Ca,36.985897.8
Sc-37,16,21,37,Sc,37.004060
Ti-37,15,22,37,Ti,37.027020
Na-38,27,11,38,Na,38.066460
Mg-38,26,12,38,Mg,38.036580
Al-38,25,13,38,Al,38.017680
Si-38,24,14,38,Si,37.995520
P-38,23,15,38,P,37.984300
S-38,22,16,38,S,37.971163
Cl-38,21,17,38,Cl,37.968010.41
Ar-38,20,18,38,Ar,37.962732.10
K-38,19,19,38,K,37.969081.11
Ca-38,18,20,38,Ca,37.976319.22
Sc-38,17,21,38,Sc,37.995440
Ti-38,16,22,38,Ti,38.012210
Na-39,28,11,39,Na,39.075120
Mg-39,27,12,39,Mg,39.045920
Al-39,26,13,39,Al,39.023070
Si-39,25,14,39,Si,39.002490
P-39,24,15,39,P,38.986290
S-39,23,16,39,S,38.975130
Cl-39,22,17,39,Cl,38.968008.2
Ar-39,21,18,39,Ar,38.964313
K-39,20,19,39,K,38.963706.485
Ca-39,19,20,39,Ca,38.970710.8
Sc-39,18,21,39,Sc,38.984785
Ti-39,17,22,39,Ti,39.002680
V-39,16,23,39,V,39.024230
Mg-40,28,12,40,Mg,40.053190
Al-40,27,13,40,Al,40.030940
Si-40,26,14,40,Si,40.006080
P-40,25,15,40,P,39.991260
S-40,24,16,40,S,39.975483
Cl-40,23,17,40,Cl,39.970420
Ar-40,22,18,40,Ar,39.962383.1220
K-40,21,19,40,K,39.963998.17
Ca-40,20,20,40,Ca,39.962590.851
Sc-40,19,21,40,Sc,39.977967
Ti-40,18,22,40,Ti,39.990350
V-40,17,23,40,V,40.013390
Mg-41,29,12,41,Mg,41.062370
Al-41,28,13,41,Al,41.037130
Si-41,27,14,41,Si,41.014170
P-41,26,15,41,P,40.994650
S-41,25,16,41,S,40.979593
Cl-41,24,17,41,Cl,40.970680
Ar-41,23,18,41,Ar,40.964500.6
K-41,22,19,41,K,40.961825.256
Ca-41,21,20,41,Ca,40.962277.91
Sc-41,20,21,41,Sc,40.969251.16
Ti-41,19,22,41,Ti,40.983150
V-41,18,23,41,V,41.000330
Cr-41,17,24,41,Cr,41.021910
Al-42,29,13,42,Al,42.045080
Si-42,28,14,42,Si,42.018080
P-42,27,15,42,P,42.001170
S-42,26,16,42,S,41.981065
Cl-42,25,17,42,Cl,41.973340
Ar-42,24,18,42,Ar,41.963046
K-42,23,19,42,K,41.962402.31
Ca-42,22,20,42,Ca,41.958617.78
Sc-42,21,21,42,Sc,41.965516.69
Ti-42,20,22,42,Ti,41.973049.37
V-42,19,23,42,V,41.991820
Cr-42,18,24,42,Cr,42.007580
Al-43,30,13,43,Al,43.051820
Si-43,29,14,43,Si,43.026120
P-43,28,15,43,P,43.005410
S-43,27,16,43,S,42.986908
Cl-43,26,17,43,Cl,42.974060
Ar-43,25,18,43,Ar,42.965636
K-43,24,19,43,K,42.960734.7
Ca-43,23,20,43,Ca,42.958766.38
Sc-43,22,21,43,Sc,42.961150.4
Ti-43,21,22,43,Ti,42.968528
V-43,20,23,43,V,42.980770
Cr-43,19,24,43,Cr,42.997890
Mn-43,18,25,43,Mn,43.018650
Si-44,30,14,44,Si,44.031470
P-44,29,15,44,P,44.011930
S-44,28,16,44,S,43.990119
Cl-44,27,17,44,Cl,43.978010
Ar-44,26,18,44,Ar,43.964923.8
K-44,25,19,44,K,43.961587.0
Ca-44,24,20,44,Ca,43.955481.5
Sc-44,23,21,44,Sc,43.959402.8
Ti-44,22,22,44,Ti,43.959689.9
V-44,21,23,44,V,43.974441
Cr-44,20,24,44,Cr,43.985590
Mn-44,19,25,44,Mn,44.008010
Si-45,31,14,45,Si,45.039820
P-45,30,15,45,P,45.017130
S-45,29,16,45,S,44.996410
Cl-45,28,17,45,Cl,44.980390
Ar-45,27,18,45,Ar,44.968039.7
K-45,26,19,45,K,44.960691.5
Ca-45,25,20,45,Ca,44.956186.3
Sc-45,24,21,45,Sc,44.955907.1
Ti-45,23,22,45,Ti,44.958120.8
V-45,22,23,45,V,44.965768.5
Cr-45,21,24,45,Cr,44.979050
Mn-45,20,25,45,Mn,44.994650
Fe-45,19,26,45,Fe,45.015470
P-46,31,15,46,P,46.024520
S-46,30,16,46,S,46.000690
Cl-46,29,17,46,Cl,45.985250
Ar-46,28,18,46,Ar,45.968039.2
K-46,27,19,46,K,45.961981.6
Ca-46,26,20,46,Ca,45.953687.7
Sc-46,25,21,46,Sc,45.955167.0
Ti-46,24,22,46,Ti,45.952626.36
V-46,23,23,46,V,45.960197.39
Cr-46,22,24,46,Cr,45.968361
Mn-46,21,25,46,Mn,45.986670
Fe-46,20,26,46,Fe,46.001300
P-47,32,15,47,P,47.030930
S-47,31,16,47,S,47.007730
Cl-47,30,17,47,Cl,46.989720
Ar-47,29,18,47,Ar,46.972767.1
K-47,28,19,47,K,46.961661.6
Ca-47,27,20,47,Ca,46.954541.1
Sc-47,26,21,47,Sc,46.952402.4
Ti-47,25,22,47,Ti,46.951757.49
V-47,24,23,47,V,46.954903.56
Cr-47,23,24,47,Cr,46.962895
Mn-47,22,25,47,Mn,46.975770
Fe-47,21,26,47,Fe,46.992350
Co-47,20,27,47,Co,47.011400
S-48,32,16,48,S,48.013300
Cl-48,31,17,48,Cl,47.995410
Ar-48,30,18,48,Ar,47.976001
K-48,29,19,48,K,47.965341.2
Ca-48,28,20,48,Ca,47.952522.654
Sc-48,27,21,48,Sc,47.952223
Ti-48,26,22,48,Ti,47.947940.68
V-48,25,23,48,V,47.952250.9
Cr-48,24,24,48,Cr,47.954029
Mn-48,23,25,48,Mn,47.968549
Fe-48,22,26,48,Fe,47.980670
Co-48,21,27,48,Co,48.001860
Ni-48,20,28,48,Ni,48.019520
S-49,33,16,49,S,49.021890
Cl-49,32,17,49,Cl,49.000790
Ar-49,31,18,49,Ar,48.981690
K-49,30,19,49,K,48.968210.8
Ca-49,29,20,49,Ca,48.955662.63
Sc-49,28,21,49,Sc,48.950013.2
Ti-49,27,22,49,Ti,48.947864.39
V-49,26,23,49,V,48.948510.5
Cr-49,25,24,49,Cr,48.951333.7
Mn-49,24,25,49,Mn,48.959613.4
Fe-49,23,26,49,Fe,48.973429
Co-49,22,27,49,Co,48.989500
Ni-49,21,28,49,Ni,49.009160
Cl-50,33,17,50,Cl,50.008270
Ar-50,32,18,50,Ar,49.985800
K-50,31,19,50,K,49.972380
Ca-50,30,20,50,Ca,49.957499.2
Sc-50,29,21,50,Sc,49.952187.4
Ti-50,28,22,50,Ti,49.944785.62
V-50,27,23,50,V,49.947156.68
Cr-50,26,24,50,Cr,49.946042.21
Mn-50,25,25,50,Mn,49.954238.16
Fe-50,24,26,50,Fe,49.962988
Co-50,23,27,50,Co,49.981120
Ni-50,22,28,50,Ni,49.996290
Cl-51,34,17,51,Cl,51.015340
Ar-51,33,18,51,Ar,50.993030
K-51,32,19,51,K,50.975829
Ca-51,31,20,51,Ca,50.960995.7
Sc-51,30,21,51,Sc,50.953568.8
Ti-51,29,22,51,Ti,50.946609.5
V-51,28,23,51,V,50.943957.66
Cr-51,27,24,51,Cr,50.944765.39
Mn-51,26,25,51,Mn,50.948208.8
Fe-51,25,26,51,Fe,50.956855.1
Co-51,24,27,51,Co,50.970650
Ni-51,23,28,51,Ni,50.987490
Cl-52,35,17,52,Cl,52.024000
Ar-52,34,18,52,Ar,51.998520
K-52,33,19,52,K,51.981600
Ca-52,32,20,52,Ca,51.963213.6
Sc-52,31,21,52,Sc,51.956496
Ti-52,30,22,52,Ti,51.946883.5
V-52,29,23,52,V,51.944773.64
Cr-52,28,24,52,Cr,51.940504.71
Mn-52,27,25,52,Mn,51.945559.09
Fe-52,26,26,52,Fe,51.948113.36
Co-52,25,27,52,Co,51.963130
Ni-52,24,28,52,Ni,51.975780
Cu-52,23,29,52,Cu,51.997980
Ar-53,35,18,53,Ar,53.007290
K-53,34,19,53,K,52.986800
Ca-53,33,20,53,Ca,52.968450
Sc-53,32,21,53,Sc,52.958379
Ti-53,31,22,53,Ti,52.949671
V-53,30,23,53,V,52.944335
Cr-53,29,24,53,Cr,52.940646.30
Mn-53,28,25,53,Mn,52.941287.5
Fe-53,27,26,53,Fe,52.945305.6
Co-53,26,27,53,Co,52.954203.3
Ni-53,25,28,53,Ni,52.968190
Cu-53,24,29,53,Cu,52.985890
Ar-54,36,18,54,Ar,54.013480
K-54,35,19,54,K,53.994470
Ca-54,34,20,54,Ca,53.972990
Sc-54,33,21,54,Sc,53.963029
Ti-54,32,22,54,Ti,53.950892
V-54,31,23,54,V,53.946432
Cr-54,30,24,54,Cr,53.938877.36
Mn-54,29,25,54,Mn,53.940355.8
Fe-54,28,26,54,Fe,53.939608.2
Co-54,27,27,54,Co,53.948459.1
Ni-54,26,28,54,Ni,53.957833
Cu-54,25,29,54,Cu,53.977200
Zn-54,24,30,54,Zn,53.993880
K-55,36,19,55,K,55.000510
Ca-55,35,20,55,Ca,54.979980
Sc-55,34,21,55,Sc,54.966890
Ti-55,33,22,55,Ti,54.955090
V-55,32,23,55,V,54.947262
Cr-55,31,24,55,Cr,54.940836.64
Mn-55,30,25,55,Mn,54.938043.04
Fe-55,29,26,55,Fe,54.938291.2
Co-55,28,27,55,Co,54.941996.4
Ni-55,27,28,55,Ni,54.951329.8
Cu-55,26,29,55,Cu,54.966040
Zn-55,25,30,55,Zn,54.984680
K-56,37,19,56,K,56.008570
Ca-56,36,20,56,Ca,55.985500
Sc-56,35,21,56,Sc,55.972610
Ti-56,34,22,56,Ti,55.957680
V-56,33,23,56,V,55.950420
Cr-56,32,24,56,Cr,55.940649.0
Mn-56,31,25,56,Mn,55.938902.8
Fe-56,30,26,56,Fe,55.934935.54
Co-56,29,27,56,Co,55.939838.0
Ni-56,28,28,56,Ni,55.942127.8
Cu-56,27,29,56,Cu,55.958529
Zn-56,26,30,56,Zn,55.972740
Ga-56,25,31,56,Ga,55.995880
K-57,38,19,57,K,57.015170
Ca-57,37,20,57,Ca,56.992960
Sc-57,36,21,57,Sc,56.977050
Ti-57,35,22,57,Ti,56.963070
V-57,34,23,57,V,56.952300
Cr-57,33,24,57,Cr,56.943612.1
Mn-57,32,25,57,Mn,56.938285.9
Fe-57,31,26,57,Fe,56.935391.95
Co-57,30,27,57,Co,56.936289.8
Ni-57,29,28,57,Ni,56.939791.4
Cu-57,28,29,57,Cu,56.949211.7
Zn-57,27,30,57,Zn,56.965060
Ga-57,26,31,57,Ga,56.983460
K-58,39,19,58,K,58.023540
Ca-58,38,20,58,Ca,57.998360
Sc-58,37,21,58,Sc,57.983380
Ti-58,36,22,58,Ti,57.966810
V-58,35,23,58,V,57.956600
Cr-58,34,24,58,Cr,57.944185
Mn-58,33,25,58,Mn,57.940066.6
Fe-58,32,26,58,Fe,57.933273.6
Co-58,31,27,58,Co,57.935751.3
Ni-58,30,28,58,Ni,57.935341.7
Cu-58,29,29,58,Cu,57.944532.3
Zn-58,28,30,58,Zn,57.954590
Ga-58,27,31,58,Ga,57.974730
Ge-58,26,32,58,Ge,57.991860
K-59,40,19,59,K,59.030860
Ca-59,39,20,59,Ca,59.006240
Sc-59,38,21,59,Sc,58.988370
Ti-59,37,22,59,Ti,58.972220
V-59,36,23,59,V,58.959620
Cr-59,35,24,59,Cr,58.948345.4
Mn-59,34,25,59,Mn,58.940391.1
Fe-59,33,26,59,Fe,58.934873.5
Co-59,32,27,59,Co,58.933193.5
Ni-59,31,28,59,Ni,58.934345.4
Cu-59,30,29,59,Cu,58.939496.7
Zn-59,29,30,59,Zn,58.949311.9
Ga-59,28,31,59,Ga,58.963760
Ge-59,27,32,59,Ge,58.982430
Ca-60,40,20,60,Ca,60.011810
Sc-60,39,21,60,Sc,59.995120
Ti-60,38,22,60,Ti,59.976280
V-60,37,23,60,V,59.964480
Cr-60,36,24,60,Cr,59.949641.7
Mn-60,35,25,60,Mn,59.943136.6
Fe-60,34,26,60,Fe,59.934070
Co-60,33,27,60,Co,59.933815.5
Ni-60,32,28,60,Ni,59.930785.1
Cu-60,31,29,60,Cu,59.937363.8
Zn-60,30,30,60,Zn,59.941841.3
Ga-60,29,31,60,Ga,59.957500
Ge-60,28,32,60,Ge,59.970450
As-60,27,33,60,As,59.993950
Ca-61,41,20,61,Ca,61.020410
Sc-61,40,21,61,Sc,61.000540
Ti-61,39,22,61,Ti,60.982430
V-61,38,23,61,V,60.967600
Cr-61,37,24,61,Cr,60.954378.1
Mn-61,36,25,61,Mn,60.944452.5
Fe-61,35,26,61,Fe,60.936746.2
Co-61,34,27,61,Co,60.932476.0
Ni-61,33,28,61,Ni,60.931054.8
Cu-61,32,29,61,Cu,60.933457.4
Zn-61,31,30,61,Zn,60.939507
Ga-61,30,31,61,Ga,60.949400
Ge-61,29,32,61,Ge,60.963730
As-61,28,33,61,As,60.981540
Sc-62,41,21,62,Sc,62.007850
Ti-62,40,22,62,Ti,61.986900
V-62,39,23,62,V,61.972930
Cr-62,38,24,62,Cr,61.956143
Mn-62,37,25,62,Mn,61.947907
Fe-62,36,26,62,Fe,61.936792
Co-62,35,27,62,Co,61.934058
Ni-62,34,28,62,Ni,61.928344.8
Cu-62,33,29,62,Cu,61.932594.8
Zn-62,32,30,62,Zn,61.934333.4
Ga-62,31,31,62,Ga,61.944189.6
Ge-62,30,32,62,Ge,61.954760
As-62,29,33,62,As,61.973780
Sc-63,42,21,63,Sc,63.014030
Ti-63,41,22,63,Ti,62.993710
V-63,40,23,63,V,62.976660
Cr-63,39,24,63,Cr,62.961160
Mn-63,38,25,63,Mn,62.949665
Fe-63,37,26,63,Fe,62.940273
Co-63,36,27,63,Co,62.933600
Ni-63,35,28,63,Ni,62.929669.0
Cu-63,34,29,63,Cu,62.929597.1
Zn-63,33,30,63,Zn,62.933211.1
Ga-63,32,31,63,Ga,62.939294.2
Ge-63,31,32,63,Ge,62.949630
As-63,30,33,63,As,62.964040
Se-63,29,34,63,Se,62.981910
Ti-64,42,22,64,Ti,63.998410
V-64,41,23,64,V,63.982480
Cr-64,40,24,64,Cr,63.963890
Mn-64,39,25,64,Mn,63.953849
Fe-64,38,26,64,Fe,63.940988
Co-64,37,27,64,Co,63.935810
Ni-64,36,28,64,Ni,63.927966.2
Cu-64,35,29,64,Cu,63.929764.0
Zn-64,34,30,64,Zn,63.929141.8
Ga-64,33,31,64,Ga,63.936840.4
Ge-64,32,32,64,Ge,63.941690
As-64,31,33,64,As,63.957560
Se-64,30,34,64,Se,63.971170
Ti-65,43,22,65,Ti,65.005590
V-65,42,23,65,V,64.987000
Cr-65,41,24,65,Cr,64.969610
Mn-65,40,25,65,Mn,64.956020
Fe-65,39,26,65,Fe,64.945015
Co-65,38,27,65,Co,64.936462.1
Ni-65,37,28,65,Ni,64.930084.6
Cu-65,36,29,65,Cu,64.927789.5
Zn-65,35,30,65,Zn,64.929240.5
Ga-65,34,31,65,Ga,64.932734.4
Ge-65,33,32,65,Ge,64.939368.1
As-65,32,33,65,As,64.949610
Se-65,31,34,65,Se,64.964550
Br-65,30,35,65,Br,64.982300
V-66,43,23,66,V,65.993240
Cr-66,42,24,66,Cr,65.973010
Mn-66,41,25,66,Mn,65.960547
Fe-66,40,26,66,Fe,65.946250
Co-66,39,27,66,Co,65.939443
Ni-66,38,28,66,Ni,65.929139.3
Cu-66,37,29,66,Cu,65.928868.8
Zn-66,36,30,66,Zn,65.926033.6
Ga-66,35,31,66,Ga,65.931589.8
Ge-66,34,32,66,Ge,65.933862.1
As-66,33,33,66,As,65.944149
Se-66,32,34,66,Se,65.955280
Br-66,31,35,66,Br,65.974700
V-67,44,23,67,V,66.998130
Cr-67,43,24,67,Cr,66.979310
Mn-67,42,25,67,Mn,66.963950
Fe-67,41,26,67,Fe,66.950930
Co-67,40,27,67,Co,66.940610
Ni-67,39,28,67,Ni,66.931569
Cu-67,38,29,67,Cu,66.927729.5
Zn-67,37,30,67,Zn,66.927127.4
Ga-67,36,31,67,Ga,66.928202.3
Ge-67,35,32,67,Ge,66.932717
As-67,34,33,67,As,66.939251.1
Se-67,33,34,67,Se,66.949990
Br-67,32,35,67,Br,66.965080
Kr-67,31,36,67,Kr,66.983310
Cr-68,44,24,68,Cr,67.983160
Mn-68,43,25,68,Mn,67.968950
Fe-68,42,26,68,Fe,67.952880
Co-68,41,27,68,Co,67.944559
Ni-68,40,28,68,Ni,67.931869
Cu-68,39,29,68,Cu,67.929610.9
Zn-68,38,30,68,Zn,67.924844.2
Ga-68,37,31,68,Ga,67.927980.2
Ge-68,36,32,68,Ge,67.928095.3
As-68,35,33,68,As,67.936774.1
Se-68,34,34,68,Se,67.941825.2
Br-68,33,35,68,Br,67.958360
Kr-68,32,36,68,Kr,67.972490
Cr-69,45,24,69,Cr,68.989660
Mn-69,44,25,69,Mn,68.972780
Fe-69,43,26,69,Fe,68.957920
Co-69,42,27,69,Co,68.945910
Ni-69,41,28,69,Ni,68.935610
Cu-69,40,29,69,Cu,68.929429.3
Zn-69,39,30,69,Zn,68.926550.4
Ga-69,38,31,69,Ga,68.925573.5
Ge-69,37,32,69,Ge,68.927964.5
As-69,36,33,69,As,68.932250
Se-69,35,34,69,Se,68.939414.8
Br-69,34,35,69,Br,68.950340
Kr-69,33,36,69,Kr,68.965500
Cr-70,46,24,70,Cr,69.993950
Mn-70,45,25,70,Mn,69.978050
Fe-70,44,26,70,Fe,69.960400
Co-70,43,27,70,Co,69.950053
Ni-70,42,28,70,Ni,69.936431.3
Cu-70,41,29,70,Cu,69.932392.1
Zn-70,40,30,70,Zn,69.925319.2
Ga-70,39,31,70,Ga,69.926021.9
Ge-70,38,32,70,Ge,69.924248.5
As-70,37,33,70,As,69.930934.6
Se-70,36,34,70,Se,69.933515.5
Br-70,35,35,70,Br,69.944792
Kr-70,34,36,70,Kr,69.955880
Mn-71,46,25,71,Mn,70.982160
Fe-71,45,26,71,Fe,70.965720
Co-71,44,27,71,Co,70.952370
Ni-71,43,28,71,Ni,70.940519.0
Cu-71,42,29,71,Cu,70.932676.8
Zn-71,41,30,71,Zn,70.927719.6
Ga-71,40,31,71,Ga,70.924702.6
Ge-71,39,32,71,Ge,70.924952.1
As-71,38,33,71,As,70.927114
Se-71,37,34,71,Se,70.932209
Br-71,36,35,71,Br,70.939342
Kr-71,35,36,71,Kr,70.950270
Rb-71,34,37,71,Rb,70.965340
Mn-72,47,25,72,Mn,71.988010
Fe-72,46,26,72,Fe,71.968600
Co-72,45,27,72,Co,71.956740
Ni-72,44,28,72,Ni,71.941785.9
Cu-72,43,29,72,Cu,71.935820.3
Zn-72,42,30,72,Zn,71.926842.8
Ga-72,41,31,72,Ga,71.926367.5
Ge-72,40,32,72,Ge,71.922075.82
As-72,39,33,72,As,71.926752
Se-72,38,34,72,Se,71.927140.5
Br-72,37,35,72,Br,71.936594.6
Kr-72,36,36,72,Kr,71.942092
Rb-72,35,37,72,Rb,71.958850
Mn-73,48,25,73,Mn,72.992810
Fe-73,47,26,73,Fe,72.974250
Co-73,46,27,73,Co,72.959240
Ni-73,45,28,73,Ni,72.946206.7
Cu-73,44,29,73,Cu,72.936674.4
Zn-73,43,30,73,Zn,72.929582.6
Ga-73,42,31,73,Ga,72.925174.7
Ge-73,41,32,73,Ge,72.923458.95
As-73,40,33,73,As,72.923829
Se-73,39,34,73,Se,72.926755
Br-73,38,35,73,Br,72.931673
Kr-73,37,36,73,Kr,72.939289
Rb-73,36,37,73,Rb,72.950600
Sr-73,35,38,73,Sr,72.965700
Fe-74,48,26,74,Fe,73.977820
Co-74,47,27,74,Co,73.963990
Ni-74,46,28,74,Ni,73.947720
Cu-74,45,29,74,Cu,73.939875
Zn-74,44,30,74,Zn,73.929407.3
Ga-74,43,31,74,Ga,73.926946
Ge-74,42,32,74,Ge,73.921177.761
As-74,41,33,74,As,73.923928.6
Se-74,40,34,74,Se,73.922475.934
Br-74,39,35,74,Br,73.929910
Kr-74,38,36,74,Kr,73.933084.0
Rb-74,37,37,74,Rb,73.944266
Sr-74,36,38,74,Sr,73.956170
Fe-75,49,26,75,Fe,74.984220
Co-75,48,27,75,Co,74.967190
Ni-75,47,28,75,Ni,74.952510
Cu-75,46,29,75,Cu,74.941523.8
Zn-75,45,30,75,Zn,74.932840.2
Ga-75,44,31,75,Ga,74.926504.5
Ge-75,43,32,75,Ge,74.922858.37
As-75,42,33,75,As,74.921594.6
Se-75,41,34,75,Se,74.922522.87
Br-75,40,35,75,Br,74.925811
Kr-75,39,36,75,Kr,74.930946
Rb-75,38,37,75,Rb,74.938573.2
Sr-75,37,38,75,Sr,74.949950
Y-75,36,39,75,Y,74.965840
Fe-76,50,26,76,Fe,75.988630
Co-76,49,27,76,Co,75.972450
Ni-76,48,28,76,Ni,75.954710
Cu-76,47,29,76,Cu,75.945269.0
Zn-76,46,30,76,Zn,75.933115.0
Ga-76,45,31,76,Ga,75.928827.6
Ge-76,44,32,76,Ge,75.921402.725
As-76,43,33,76,As,75.922392.0
Se-76,42,34,76,Se,75.919213.703
Br-76,41,35,76,Br,75.924542
Kr-76,40,36,76,Kr,75.925911
Rb-76,39,37,76,Rb,75.935073.0
Sr-76,38,38,76,Sr,75.941760
Y-76,37,39,76,Y,75.958940
Co-77,50,27,77,Co,76.976480
Ni-77,49,28,77,Ni,76.959900
Cu-77,48,29,77,Cu,76.947543.6
Zn-77,47,30,77,Zn,76.936887.2
Ga-77,46,31,77,Ga,76.929154.3
Ge-77,45,32,77,Ge,76.923549.84
As-77,44,33,77,As,76.920647.6
Se-77,43,34,77,Se,76.919914.15
Br-77,42,35,77,Br,76.921379
Kr-77,41,36,77,Kr,76.924670.0
Rb-77,40,37,77,Rb,76.930401.6
Sr-77,39,38,77,Sr,76.937945
Y-77,38,39,77,Y,76.950150
Zr-77,37,40,77,Zr,76.966080
Co-78,51,27,78,Co,77.983550
Ni-78,50,28,78,Ni,77.962560
Cu-78,49,29,78,Cu,77.951917
Zn-78,48,30,78,Zn,77.938289.2
Ga-78,47,31,78,Ga,77.931610.9
Ge-78,46,32,78,Ge,77.922853
As-78,45,33,78,As,77.921828
Se-78,44,34,78,Se,77.917309.24
Br-78,43,35,78,Br,77.921146
Kr-78,42,36,78,Kr,77.920366.3
Rb-78,41,37,78,Rb,77.928142
Sr-78,40,38,78,Sr,77.932180
Y-78,39,39,78,Y,77.943990
Zr-78,38,40,78,Zr,77.956150
Ni-79,51,28,79,Ni,78.969770
Cu-79,50,29,79,Cu,78.954470
Zn-79,49,30,79,Zn,78.942638.1
Ga-79,48,31,79,Ga,78.932851.6
Ge-79,47,32,79,Ge,78.925360
As-79,46,33,79,As,78.920948
Se-79,45,34,79,Se,78.918499.25
Br-79,44,35,79,Br,78.918337.6
Kr-79,43,36,79,Kr,78.920083
Rb-79,42,37,79,Rb,78.923990.1
Sr-79,41,38,79,Sr,78.929705
Y-79,40,39,79,Y,78.937950
Zr-79,39,40,79,Zr,78.949790
Nb-79,38,41,79,Nb,78.966020
Ni-80,52,28,80,Ni,79.975050
Cu-80,51,29,80,Cu,79.960620
Zn-80,50,30,80,Zn,79.944552.9
Ga-80,49,31,80,Ga,79.936421
Ge-80,48,32,80,Ge,79.925350.8
As-80,47,33,80,As,79.922474
Se-80,46,34,80,Se,79.916521.8
Br-80,45,35,80,Br,79.918529.8
Kr-80,44,36,80,Kr,79.916377.9
Rb-80,43,37,80,Rb,79.922516.4
Sr-80,42,38,80,Sr,79.924518
Y-80,41,39,80,Y,79.934355
Zr-80,40,40,80,Zr,79.941210
Nb-80,39,41,80,Nb,79.958750
Ni-81,53,28,81,Ni,80.982730
Cu-81,52,29,81,Cu,80.965740
Zn-81,51,30,81,Zn,80.950403
Ga-81,50,31,81,Ga,80.938134
Ge-81,49,32,81,Ge,80.928832.9
As-81,48,33,81,As,80.922132.3
Se-81,47,34,81,Se,80.917993.0
Br-81,46,35,81,Br,80.916288.2
Kr-81,45,36,81,Kr,80.916589.7
Rb-81,44,37,81,Rb,80.918994
Sr-81,43,38,81,Sr,80.923211
Y-81,42,39,81,Y,80.929454
Zr-81,41,40,81,Zr,80.938250
Nb-81,40,41,81,Nb,80.950230
Mo-81,39,42,81,Mo,80.966230
Ni-82,54,28,82,Ni,81.988490
Cu-82,53,29,82,Cu,81.972380
Zn-82,52,30,82,Zn,81.954574
Ga-82,51,31,82,Ga,81.943176.5
Ge-82,50,32,82,Ge,81.929774.0
As-82,49,33,82,As,81.924739
Se-82,48,34,82,Se,81.916699.5
Br-82,47,35,82,Br,81.916801.8
Kr-82,46,36,82,Kr,81.913481.154
Rb-82,45,37,82,Rb,81.918209
Sr-82,44,38,82,Sr,81.918400
Y-82,43,39,82,Y,81.926930
Zr-82,42,40,82,Zr,81.931707.5
Nb-82,41,41,82,Nb,81.944380
Mo-82,40,42,82,Mo,81.956660
Cu-83,54,29,83,Cu,82.978110
Zn-83,53,30,83,Zn,82.961040
Ga-83,52,31,83,Ga,82.947120.3
Ge-83,51,32,83,Ge,82.934539.1
As-83,50,33,83,As,82.925207
Se-83,49,34,83,Se,82.919119
Br-83,48,35,83,Br,82.915175
Kr-83,47,36,83,Kr,82.914126.517
Rb-83,46,37,83,Rb,82.915114.2
Sr-83,45,38,83,Sr,82.917554
Y-83,44,39,83,Y,82.922484
Zr-83,43,40,83,Zr,82.929241
Nb-83,42,41,83,Nb,82.938150
Mo-83,41,42,83,Mo,82.950250
Tc-83,40,43,83,Tc,82.966380
Cu-84,55,29,84,Cu,83.985270
Zn-84,54,30,84,Zn,83.965830
Ga-84,53,31,84,Ga,83.952660
Ge-84,52,32,84,Ge,83.937575
As-84,51,33,84,As,83.929303
Se-84,50,34,84,Se,83.918466.8
Br-84,49,35,84,Br,83.916496
Kr-84,48,36,84,Kr,83.911497.727
Rb-84,47,37,84,Rb,83.914375.2
Sr-84,46,38,84,Sr,83.913419.1
Y-84,45,39,84,Y,83.920671
Zr-84,44,40,84,Zr,83.923326
Nb-84,43,41,84,Nb,83.934305.7
Mo-84,42,42,84,Mo,83.941850
Tc-84,41,43,84,Tc,83.959530
Zn-85,55,30,85,Zn,84.973050
Ga-85,54,31,85,Ga,84.957330
Ge-85,53,32,85,Ge,84.942970
As-85,52,33,85,As,84.932164
Se-85,51,34,85,Se,84.922260.8
Br-85,50,35,85,Br,84.915646
Kr-85,49,36,85,Kr,84.912527.3
Rb-85,48,37,85,Rb,84.911789.736
Sr-85,47,38,85,Sr,84.912932
Y-85,46,39,85,Y,84.916433
Zr-85,45,40,85,Zr,84.921443
Nb-85,44,41,85,Nb,84.928846
Mo-85,43,42,85,Mo,84.938261
Tc-85,42,43,85,Tc,84.950780
Ru-85,41,44,85,Ru,84.967120
Zn-86,56,30,86,Zn,85.978460
Ga-86,55,31,86,Ga,85.963760
Ge-86,54,32,86,Ge,85.946970
As-86,53,33,86,As,85.936702
Se-86,52,34,86,Se,85.924311.7
Br-86,51,35,86,Br,85.918805
Kr-86,50,36,86,Kr,85.910610.625
Rb-86,49,37,86,Rb,85.911167.44
Sr-86,48,38,86,Sr,85.909260.725
Y-86,47,39,86,Y,85.914886
Zr-86,46,40,86,Zr,85.916297
Nb-86,45,41,86,Nb,85.925782
Mo-86,44,42,86,Mo,85.931174
Tc-86,43,43,86,Tc,85.944640
Ru-86,42,44,86,Ru,85.957310
Ga-87,56,31,87,Ga,86.969010
Ge-87,55,32,87,Ge,86.953200
As-87,54,33,87,As,86.940292
Se-87,53,34,87,Se,86.928688.6
Br-87,52,35,87,Br,86.920674
Kr-87,51,36,87,Kr,86.913354.76
Rb-87,50,37,87,Rb,86.909180.529
Sr-87,49,38,87,Sr,86.908877.495
Y-87,48,39,87,Y,86.910876.1
Zr-87,47,40,87,Zr,86.914817
Nb-87,46,41,87,Nb,86.920692
Mo-87,45,42,87,Mo,86.928196
Tc-87,44,43,87,Tc,86.938067
Ru-87,43,44,87,Ru,86.950910
Ga-88,57,31,88,Ga,87.975960
Ge-88,56,32,88,Ge,87.957570
As-88,55,33,88,As,87.945840
Se-88,54,34,88,Se,87.931417
Br-88,53,35,88,Br,87.924083
Kr-88,52,36,88,Kr,87.914447.9
Rb-88,51,37,88,Rb,87.911315.59
Sr-88,50,38,88,Sr,87.905612.254
Y-88,49,39,88,Y,87.909501.3
Zr-88,48,40,88,Zr,87.910221
Nb-88,47,41,88,Nb,87.918230
Mo-88,46,42,88,Mo,87.921968
Tc-88,45,43,88,Tc,87.933794
Ru-88,44,44,88,Ru,87.941660
Rh-88,43,45,88,Rh,87.960430
Ge-89,57,32,89,Ge,88.964530
As-89,56,33,89,As,88.950050
Se-89,55,34,89,Se,88.936669
Br-89,54,35,89,Br,88.926705
Kr-89,53,36,89,Kr,88.917835.4
Rb-89,52,37,89,Rb,88.912278
Sr-89,51,38,89,Sr,88.907450.81
Y-89,50,39,89,Y,88.905838.2
Zr-89,49,40,89,Zr,88.908879.8
Nb-89,48,41,89,Nb,88.913445
Mo-89,47,42,89,Mo,88.919468
Tc-89,46,43,89,Tc,88.927649
Ru-89,45,44,89,Ru,88.937338
Rh-89,44,45,89,Rh,88.950990
Ge-90,58,32,90,Ge,89.969440
As-90,57,33,90,As,89.956000
Se-90,56,34,90,Se,89.940100
Br-90,55,35,90,Br,89.931293
Kr-90,54,36,90,Kr,89.919527.9
Rb-90,53,37,90,Rb,89.914798
Sr-90,52,38,90,Sr,89.907727.9
Y-90,51,39,90,Y,89.907141.7
Zr-90,50,40,90,Zr,89.904698.76
Nb-90,49,41,90,Nb,89.911259
Mo-90,48,42,90,Mo,89.913931
Tc-90,47,43,90,Tc,89.924073.9
Ru-90,46,44,90,Ru,89.930344
Rh-90,45,45,90,Rh,89.944570
Pd-90,44,46,90,Pd,89.957370
As-91,58,33,91,As,90.960820
Se-91,57,34,91,Se,90.945700
Br-91,56,35,91,Br,90.934399
Kr-91,55,36,91,Kr,90.923806.3
Rb-91,54,37,91,Rb,90.916537
Sr-91,53,38,91,Sr,90.910196
Y-91,52,39,91,Y,90.907298.0
Zr-91,51,40,91,Zr,90.905640.21
Nb-91,50,41,91,Nb,90.906990
Mo-91,49,42,91,Mo,90.911745
Tc-91,48,43,91,Tc,90.918425.0
Ru-91,47,44,91,Ru,90.926741.5
Rh-91,46,45,91,Rh,90.937120
Pd-91,45,46,91,Pd,90.950440
As-92,59,33,92,As,91.967390
Se-92,58,34,92,Se,91.949840
Br-92,57,35,92,Br,91.939632
Kr-92,56,36,92,Kr,91.926173.1
Rb-92,55,37,92,Rb,91.919728
Sr-92,54,38,92,Sr,91.911038
Y-92,53,39,92,Y,91.908946
Zr-92,52,40,92,Zr,91.905035.34
Nb-92,51,41,92,Nb,91.907188.6
Mo-92,50,42,92,Mo,91.906807.15
Tc-92,49,43,92,Tc,91.915270
Ru-92,48,44,92,Ru,91.920234.4
Rh-92,47,45,92,Rh,91.932368
Pd-92,46,46,92,Pd,91.941190
Ag-92,45,47,92,Ag,91.959710
Se-93,59,34,93,Se,92.956140
Br-93,58,35,93,Br,92.943220
Kr-93,57,36,93,Kr,92.931147.2
Rb-93,56,37,93,Rb,92.922039
Sr-93,55,38,93,Sr,92.914024
Y-93,54,39,93,Y,92.909578
Zr-93,53,40,93,Zr,92.906470.7
Nb-93,52,41,93,Nb,92.906373.2
Mo-93,51,42,93,Mo,92.906808.77
Tc-93,50,43,93,Tc,92.910245.1
Ru-93,49,44,93,Ru,92.917104.4
Rh-93,48,45,93,Rh,92.925912.8
Pd-93,47,46,93,Pd,92.936680
Ag-93,46,47,93,Ag,92.950190
Se-94,60,34,94,Se,93.960490
Br-94,59,35,94,Br,93.948850
Kr-94,58,36,94,Kr,93.934140
Rb-94,57,37,94,Rb,93.926394.8
Sr-94,56,38,94,Sr,93.915355.6
Y-94,55,39,94,Y,93.911592
Zr-94,54,40,94,Zr,93.906312.52
Nb-94,53,41,94,Nb,93.907279.0
Mo-94,52,42,94,Mo,93.905083.59
Tc-94,51,43,94,Tc,93.909652
Ru-94,50,44,94,Ru,93.911343
Rh-94,49,45,94,Rh,93.921730
Pd-94,48,46,94,Pd,93.929036
Ag-94,47,47,94,Ag,93.943740
Cd-94,46,48,94,Cd,93.956590
Se-95,61,34,95,Se,94.967300
Br-95,60,35,95,Br,94.952930
Kr-95,59,36,95,Kr,94.939711
Rb-95,58,37,95,Rb,94.929264
Sr-95,57,38,95,Sr,94.919358
Y-95,56,39,95,Y,94.912820
Zr-95,55,40,95,Zr,94.908040.3
Nb-95,54,41,95,Nb,94.906831.1
Mo-95,53,42,95,Mo,94.905837.44
Tc-95,52,43,95,Tc,94.907652
Ru-95,51,44,95,Ru,94.910404
Rh-95,50,45,95,Rh,94.915898
Pd-95,49,46,95,Pd,94.924889
Ag-95,48,47,95,Ag,94.935690
Cd-95,47,48,95,Cd,94.949480
Br-96,61,35,96,Br,95.958980
Kr-96,60,36,96,Kr,95.943014
Rb-96,59,37,96,Rb,95.934133
Sr-96,58,38,96,Sr,95.921719
Y-96,57,39,96,Y,95.915909
Zr-96,56,40,96,Zr,95.908277.62
Nb-96,55,41,96,Nb,95.908101.59
Mo-96,54,42,96,Mo,95.904674.77
Tc-96,53,43,96,Tc,95.907867
Ru-96,52,44,96,Ru,95.907588.91
Rh-96,51,45,96,Rh,95.914452
Pd-96,50,46,96,Pd,95.918214
Ag-96,49,47,96,Ag,95.930740
Cd-96,48,48,96,Cd,95.940340
In-96,47,49,96,In,95.959110
Br-97,62,35,97,Br,96.963500
Kr-97,61,36,97,Kr,96.949090
Rb-97,60,37,97,Rb,96.937177.1
Sr-97,59,38,97,Sr,96.926376
Y-97,58,39,97,Y,96.918287
Zr-97,57,40,97,Zr,96.910963.80
Nb-97,56,41,97,Nb,96.908102
Mo-97,55,42,97,Mo,96.906016.90
Tc-97,54,43,97,Tc,96.906361
Ru-97,53,44,97,Ru,96.907545.8
Rh-97,52,45,97,Rh,96.911330
Pd-97,51,46,97,Pd,96.916472
Ag-97,50,47,97,Ag,96.923881
Cd-97,49,48,97,Cd,96.934800
In-97,48,49,97,In,96.949130
Br-98,63,35,98,Br,97.969890
Kr-98,62,36,98,Kr,97.952640
Rb-98,61,37,98,Rb,97.941632
Sr-98,60,38,98,Sr,97.928693
Y-98,59,39,98,Y,97.922395
Zr-98,58,40,98,Zr,97.912740
Nb-98,57,41,98,Nb,97.910333
Mo-98,56,42,98,Mo,97.905403.61
Tc-98,55,43,98,Tc,97.907211
Ru-98,54,44,98,Ru,97.905287
Rh-98,53,45,98,Rh,97.910708
Pd-98,52,46,98,Pd,97.912698
Ag-98,51,47,98,Ag,97.921560
Cd-98,50,48,98,Cd,97.927390
In-98,49,49,98,In,97.942130
Kr-99,63,36,99,Kr,98.958780
Rb-99,62,37,99,Rb,98.945119
Sr-99,61,38,99,Sr,98.932884
Y-99,60,39,99,Y,98.924161
Zr-99,59,40,99,Zr,98.916675
Nb-99,58,41,99,Nb,98.911609
Mo-99,57,42,99,Mo,98.907707.30
Tc-99,56,43,99,Tc,98.906249.7
Ru-99,55,44,99,Ru,98.905930.3
Rh-99,54,45,99,Rh,98.908121
Pd-99,53,46,99,Pd,98.911773
Ag-99,52,47,99,Ag,98.917646
Cd-99,51,48,99,Cd,98.924925.8
In-99,50,49,99,In,98.934110
Sn-99,49,50,99,Sn,98.948500
Kr-100,64,36,100,Kr,99.963000
Rb-100,63,37,100,Rb,99.950332
Sr-100,62,38,100,Sr,99.935783
Y-100,61,39,100,Y,99.927728
Zr-100,60,40,100,Zr,99.918010
Nb-100,59,41,100,Nb,99.914341
Mo-100,58,42,100,Mo,99.907468.0
Tc-100,57,43,100,Tc,99.907652.7
Ru-100,56,44,100,Ru,99.904210.5
Rh-100,55,45,100,Rh,99.908114
Pd-100,54,46,100,Pd,99.908520
Ag-100,53,47,100,Ag,99.916115
Cd-100,52,48,100,Cd,99.920348.8
In-100,51,49,100,In,99.931101.9
Sn-100,50,50,100,Sn,99.938650
Kr-101,65,36,101,Kr,100.969320
Rb-101,64,37,101,Rb,100.954302
Sr-101,63,38,101,Sr,100.940606
Y-101,62,39,101,Y,100.930161
Zr-101,61,40,101,Zr,100.921458
Nb-101,60,41,101,Nb,100.915307
Mo-101,59,42,101,Mo,100.910337.6
Tc-101,58,43,101,Tc,100.907305
Ru-101,57,44,101,Ru,100.905573.1
Rh-101,56,45,101,Rh,100.906159
Pd-101,55,46,101,Pd,100.908285
Ag-101,54,47,101,Ag,100.912684
Cd-101,53,48,101,Cd,100.918586.2
In-101,52,49,101,In,100.926414
Sn-101,51,50,101,Sn,100.935260
Rb-102,65,37,102,Rb,101.960010
Sr-102,64,38,102,Sr,101.944000
Y-102,63,39,102,Y,101.934328
Zr-102,62,40,102,Zr,101.923154
Nb-102,61,41,102,Nb,101.918090.4
Mo-102,60,42,102,Mo,101.910294
Tc-102,59,43,102,Tc,101.909207
Ru-102,58,44,102,Ru,101.904340.3
Rh-102,57,45,102,Rh,101.906834
Pd-102,56,46,102,Pd,101.905632.3
Ag-102,55,47,102,Ag,101.911705
Cd-102,54,48,102,Cd,101.914481.8
In-102,53,49,102,In,101.924106
Sn-102,52,50,102,Sn,101.930290
Sb-102,51,51,102,Sb,101.945140
Rb-103,66,37,103,Rb,102.964400
Sr-103,65,38,103,Sr,102.949240
Y-103,64,39,103,Y,102.937244
Zr-103,63,40,103,Zr,102.927204
Nb-103,62,41,103,Nb,102.919453
Mo-103,61,42,103,Mo,102.913092
Tc-103,60,43,103,Tc,102.909174
Ru-103,59,44,103,Ru,102.906314.8
Rh-103,58,45,103,Rh,102.905494.1
Pd-103,57,46,103,Pd,102.906111.1
Ag-103,56,47,103,Ag,102.908961
Cd-103,55,48,103,Cd,102.913416.9
In-103,54,49,103,In,102.919879
Sn-103,53,50,103,Sn,102.927970
Sb-103,52,51,103,Sb,102.939160
Rb-104,67,37,104,Rb,103.970530
Sr-104,66,38,104,Sr,103.953020
Y-104,65,39,104,Y,103.941940
Zr-104,64,40,104,Zr,103.929449
Nb-104,63,41,104,Nb,103.922907.7
Mo-104,62,42,104,Mo,103.913747
Tc-104,61,43,104,Tc,103.911434
Ru-104,60,44,104,Ru,103.905425.3
Rh-104,59,45,104,Rh,103.906645.3
Pd-104,58,46,104,Pd,103.904030.4
Ag-104,57,47,104,Ag,103.908624
Cd-104,56,48,104,Cd,103.909856.2
In-104,55,49,104,In,103.918215
Sn-104,54,50,104,Sn,103.923105
Sb-104,53,51,104,Sb,103.936340
Te-104,52,52,104,Te,103.946720
Sr-105,67,38,105,Sr,104.959000
Y-105,66,39,105,Y,104.945710
Zr-105,65,40,105,Zr,104.934022
Nb-105,64,41,105,Nb,104.924943
Mo-105,63,42,105,Mo,104.916982
Tc-105,62,43,105,Tc,104.911660
Ru-105,61,44,105,Ru,104.907745.5
Rh-105,60,45,105,Rh,104.905687.8
Pd-105,59,46,105,Pd,104.905079.5
Ag-105,58,47,105,Ag,104.906526
Cd-105,57,48,105,Cd,104.909463.9
In-105,56,49,105,In,104.914502
Sn-105,55,50,105,Sn,104.921268
Sb-105,54,51,105,Sb,104.931277
Te-105,53,52,105,Te,104.943300
Sr-106,68,38,106,Sr,105.963180
Y-106,67,39,106,Y,105.950840
Zr-106,66,40,106,Zr,105.936930
Nb-106,65,41,106,Nb,105.928928.5
Mo-106,64,42,106,Mo,105.918273
Tc-106,63,43,106,Tc,105.914357
Ru-106,62,44,106,Ru,105.907328
Rh-106,61,45,106,Rh,105.907286
Pd-106,60,46,106,Pd,105.903480.3
Ag-106,59,47,106,Ag,105.906663
Cd-106,58,48,106,Cd,105.906459.8
In-106,57,49,106,In,105.913464
Sn-106,56,50,106,Sn,105.916957
Sb-106,55,51,106,Sb,105.928638
Te-106,54,52,106,Te,105.937500
I-106,53,53,106,I,105.953520
Sr-107,69,38,107,Sr,106.969670
Y-107,68,39,107,Y,106.954940
Zr-107,67,40,107,Zr,106.942010
Nb-107,66,41,107,Nb,106.931590
Mo-107,65,42,107,Mo,106.922120
Tc-107,64,43,107,Tc,106.915458
Ru-107,63,44,107,Ru,106.909970
Rh-107,62,45,107,Rh,106.906748
Pd-107,61,46,107,Pd,106.905128.1
Ag-107,60,47,107,Ag,106.905091.5
Cd-107,59,48,107,Cd,106.906612.0
In-107,58,49,107,In,106.910287
Sn-107,57,50,107,Sn,106.915714
Sb-107,56,51,107,Sb,106.924151
Te-107,55,52,107,Te,106.934880
I-107,54,53,107,I,106.946940
Y-108,69,39,108,Y,107.960520
Zr-108,68,40,108,Zr,107.945300
Nb-108,67,41,108,Nb,107.936076
Mo-108,66,42,108,Mo,107.924048
Tc-108,65,43,108,Tc,107.918493
Ru-108,64,44,108,Ru,107.910186
Rh-108,63,45,108,Rh,107.908715
Pd-108,62,46,108,Pd,107.903891.8
Ag-108,61,47,108,Ag,107.905950.2
Cd-108,60,48,108,Cd,107.904183.6
In-108,59,49,108,In,107.909694
Sn-108,58,50,108,Sn,107.911894
Sb-108,57,51,108,Sb,107.922227
Te-108,56,52,108,Te,107.929380
I-108,55,53,108,I,107.943350
Xe-108,54,54,108,Xe,107.954230
Y-109,70,39,109,Y,108.965130
Zr-109,69,40,109,Zr,108.950910
Nb-109,68,41,109,Nb,108.939140
Mo-109,67,42,109,Mo,108.928438
Tc-109,66,43,109,Tc,108.920254
Ru-109,65,44,109,Ru,108.913324
Rh-109,64,45,109,Rh,108.908750
Pd-109,63,46,109,Pd,108.905950.6
Ag-109,62,47,109,Ag,108.904755.8
Cd-109,61,48,109,Cd,108.904986.7
In-109,60,49,109,In,108.907150
Sn-109,59,50,109,Sn,108.911293
Sb-109,58,51,109,Sb,108.918141
Te-109,57,52,109,Te,108.927305
I-109,56,53,109,I,108.938086
Xe-109,55,54,109,Xe,108.950430
Zr-110,70,40,110,Zr,109.954680
Nb-110,69,41,110,Nb,109.943840
Mo-110,68,42,110,Mo,109.930718
Tc-110,67,43,110,Tc,109.923741
Ru-110,66,44,110,Ru,109.914039
Rh-110,65,45,110,Rh,109.911080
Pd-110,64,46,110,Pd,109.905172.9
Ag-110,63,47,110,Ag,109.906110.7
Cd-110,62,48,110,Cd,109.903007.5
In-110,61,49,110,In,109.907171
Sn-110,60,50,110,Sn,109.907845
Sb-110,59,51,110,Sb,109.916854
Te-110,58,52,110,Te,109.922458
I-110,57,53,110,I,109.935090
Xe-110,56,54,110,Xe,109.944260
Zr-111,71,40,111,Zr,110.960840
Nb-111,70,41,111,Nb,110.947440
Mo-111,69,42,111,Mo,110.935652
Tc-111,68,43,111,Tc,110.925899
Ru-111,67,44,111,Ru,110.917568
Rh-111,66,45,111,Rh,110.911643
Pd-111,65,46,111,Pd,110.907690.4
Ag-111,64,47,111,Ag,110.905296.8
Cd-111,63,48,111,Cd,110.904183.8
In-111,62,49,111,In,110.905107
Sn-111,61,50,111,Sn,110.907741
Sb-111,60,51,111,Sb,110.913218
Te-111,59,52,111,Te,110.921001
I-111,58,53,111,I,110.930269
Xe-111,57,54,111,Xe,110.941470
Cs-111,56,55,111,Cs,110.953950
Zr-112,72,40,112,Zr,111.965200
Nb-112,71,41,112,Nb,111.952690
Mo-112,70,42,112,Mo,111.938290
Tc-112,69,43,112,Tc,111.929942
Ru-112,68,44,112,Ru,111.918807
Rh-112,67,45,112,Rh,111.914410
Pd-112,66,46,112,Pd,111.907331
Ag-112,65,47,112,Ag,111.907048.5
Cd-112,64,48,112,Cd,111.902763.90
In-112,63,49,112,In,111.905539
Sn-112,62,50,112,Sn,111.904824.9
Sb-112,61,51,112,Sb,111.912400
Te-112,60,52,112,Te,111.916728
I-112,59,53,112,I,111.928005
Xe-112,58,54,112,Xe,111.935559
Cs-112,57,55,112,Cs,111.950170
Zr-113,73,40,113,Zr,112.971720
Nb-113,72,41,113,Nb,112.956830
Mo-113,71,42,113,Mo,112.943480
Tc-113,70,43,113,Tc,112.932569
Ru-113,69,44,113,Ru,112.922850
Rh-113,68,45,113,Rh,112.915440
Pd-113,67,46,113,Pd,112.910262
Ag-113,66,47,113,Ag,112.906573
Cd-113,65,48,113,Cd,112.904408.11
In-113,64,49,113,In,112.904060.45
Sn-113,63,50,113,Sn,112.905175.9
Sb-113,62,51,113,Sb,112.909375
Te-113,61,52,113,Te,112.915890
I-113,60,53,113,I,112.923650
Xe-113,59,54,113,Xe,112.933222
Cs-113,58,55,113,Cs,112.944428
Ba-113,57,56,113,Ba,112.957370
Nb-114,73,41,114,Nb,113.962470
Mo-114,72,42,114,Mo,113.946670
Tc-114,71,43,114,Tc,113.937090
Ru-114,70,44,114,Ru,113.924614
Rh-114,69,45,114,Rh,113.918720
Pd-114,68,46,114,Pd,113.910369
Ag-114,67,47,114,Ag,113.908823
Cd-114,66,48,114,Cd,113.903365.00
In-114,65,49,114,In,113.904916.4
Sn-114,64,50,114,Sn,113.902780.13
Sb-114,63,51,114,Sb,113.909289
Te-114,62,52,114,Te,113.912088
I-114,61,53,114,I,113.922019
Xe-114,60,54,114,Xe,113.927980
Cs-114,59,55,114,Cs,113.941290
Ba-114,58,56,114,Ba,113.950720
Nb-115,74,41,115,Nb,114.966850
Mo-115,73,42,115,Mo,114.952170
Tc-115,72,43,115,Tc,114.940100
Ru-115,71,44,115,Ru,114.929033
Rh-115,70,45,115,Rh,114.920312
Pd-115,69,46,115,Pd,114.913659
Ag-115,68,47,115,Ag,114.908767
Cd-115,67,48,115,Cd,114.905437.4
In-115,66,49,115,In,114.903878.773
Sn-115,65,50,115,Sn,114.903344.696
Sb-115,64,51,115,Sb,114.906598
Te-115,63,52,115,Te,114.911900
I-115,62,53,115,I,114.918050
Xe-115,61,54,115,Xe,114.926294
Cs-115,60,55,115,Cs,114.935910
Ba-115,59,56,115,Ba,114.947480
Nb-116,75,41,116,Nb,115.972910
Mo-116,74,42,116,Mo,115.955760
Tc-116,73,43,116,Tc,115.945020
Ru-116,72,44,116,Ru,115.931219
Rh-116,71,45,116,Rh,115.924060
Pd-116,70,46,116,Pd,115.914298
Ag-116,69,47,116,Ag,115.911387
Cd-116,68,48,116,Cd,115.904763.23
In-116,67,49,116,In,115.905259.99
Sn-116,66,50,116,Sn,115.901742.83
Sb-116,65,51,116,Sb,115.906793
Te-116,64,52,116,Te,115.908466
I-116,63,53,116,I,115.916890
Xe-116,62,54,116,Xe,115.921581
Cs-116,61,55,116,Cs,115.933400
Ba-116,60,56,116,Ba,115.941620
La-116,59,57,116,La,115.957010
Mo-117,75,42,117,Mo,116.961690
Tc-117,74,43,117,Tc,116.948320
Ru-117,73,44,117,Ru,116.936140
Rh-117,72,45,117,Rh,116.926036
Pd-117,71,46,117,Pd,116.917956
Ag-117,70,47,117,Ag,116.911774
Cd-117,69,48,117,Cd,116.907226.0
In-117,68,49,117,In,116.904516
Sn-117,67,50,117,Sn,116.902954.0
Sb-117,66,51,117,Sb,116.904842
Te-117,65,52,117,Te,116.908646
I-117,64,53,117,I,116.913646
Xe-117,63,54,117,Xe,116.920359
Cs-117,62,55,117,Cs,116.928620
Ba-117,61,56,117,Ba,116.938320
La-117,60,57,117,La,116.950330
Mo-118,76,42,118,Mo,117.965250
Tc-118,75,43,118,Tc,117.953530
Ru-118,74,44,118,Ru,117.938810
Rh-118,73,45,118,Rh,117.930341
Pd-118,72,46,118,Pd,117.919067.3
Ag-118,71,47,118,Ag,117.914595.5
Cd-118,70,48,118,Cd,117.906922
In-118,69,49,118,In,117.906357
Sn-118,68,50,118,Sn,117.901606.6
Sb-118,67,51,118,Sb,117.905532
Te-118,66,52,118,Te,117.905860
I-118,65,53,118,I,117.913074
Xe-118,64,54,118,Xe,117.916179
Cs-118,63,55,118,Cs,117.926560
Ba-118,62,56,118,Ba,117.933230
La-118,61,57,118,La,117.946730
Mo-119,77,42,119,Mo,118.971470
Tc-119,76,43,119,Tc,118.956880
Ru-119,75,44,119,Ru,118.944090
Rh-119,74,45,119,Rh,118.932557
Pd-119,73,46,119,Pd,118.923341
Ag-119,72,47,119,Ag,118.915570
Cd-119,71,48,119,Cd,118.909850
In-119,70,49,119,In,118.905852
Sn-119,69,50,119,Sn,118.903311.3
Sb-119,68,51,119,Sb,118.903944
Te-119,67,52,119,Te,118.906406
I-119,66,53,119,I,118.910061
Xe-119,65,54,119,Xe,118.915411
Cs-119,64,55,119,Cs,118.922377
Ba-119,63,56,119,Ba,118.930660
La-119,62,57,119,La,118.940930
Ce-119,61,58,119,Ce,118.952960
Tc-120,77,43,120,Tc,119.962430
Ru-120,76,44,120,Ru,119.946620
Rh-120,75,45,120,Rh,119.937070
Pd-120,74,46,120,Pd,119.924551.7
Ag-120,73,47,120,Ag,119.918785
Cd-120,72,48,120,Cd,119.909868
In-120,71,49,120,In,119.907970
Sn-120,70,50,120,Sn,119.902202.6
Sb-120,69,51,120,Sb,119.905080
Te-120,68,52,120,Te,119.904065.8
I-120,67,53,120,I,119.910094
Xe-120,66,54,120,Xe,119.911784
Cs-120,65,55,120,Cs,119.920677
Ba-120,64,56,120,Ba,119.926040
La-120,63,57,120,La,119.938200
Ce-120,62,58,120,Ce,119.946610
Tc-121,78,43,121,Tc,120.966140
Ru-121,77,44,121,Ru,120.952100
Rh-121,76,45,121,Rh,120.939610
Pd-121,75,46,121,Pd,120.928950
Ag-121,74,47,121,Ag,120.920125
Cd-121,73,48,121,Cd,120.912963.7
In-121,72,49,121,In,120.907853
Sn-121,71,50,121,Sn,120.904243.5
Sb-121,70,51,121,Sb,120.903811.4
Te-121,69,52,121,Te,120.904945
I-121,68,53,121,I,120.907411
Xe-121,67,54,121,Xe,120.911453
Cs-121,66,55,121,Cs,120.917227
Ba-121,65,56,121,Ba,120.924050
La-121,64,57,121,La,120.933240
Ce-121,63,58,121,Ce,120.943440
Pr-121,62,59,121,Pr,120.955390
Tc-122,79,43,122,Tc,121.971760
Ru-122,78,44,122,Ru,121.955150
Rh-122,77,45,122,Rh,121.944310
Pd-122,76,46,122,Pd,121.930632
Ag-122,75,47,122,Ag,121.923660
Cd-122,74,48,122,Cd,121.913459.1
In-122,73,49,122,In,121.910280
Sn-122,72,50,122,Sn,121.903445.5
Sb-122,71,51,122,Sb,121.905169.3
Te-122,70,52,122,Te,121.903044.7
I-122,69,53,122,I,121.907590
Xe-122,68,54,122,Xe,121.908368
Cs-122,67,55,122,Cs,121.916110
Ba-122,66,56,122,Ba,121.919900
La-122,65,57,122,La,121.930710
Ce-122,64,58,122,Ce,121.937870
Pr-122,63,59,122,Pr,121.951930
Ru-123,79,44,123,Ru,122.960760
Rh-123,78,45,123,Rh,122.947190
Pd-123,77,46,123,Pd,122.935130
Ag-123,76,47,123,Ag,122.925320
Cd-123,75,48,123,Cd,122.916892.5
In-123,74,49,123,In,122.910435
Sn-123,73,50,123,Sn,122.905727.1
Sb-123,72,51,123,Sb,122.904215.3
Te-123,71,52,123,Te,122.904271.0
I-123,70,53,123,I,122.905590
Xe-123,69,54,123,Xe,122.908482
Cs-123,68,55,123,Cs,122.912996
Ba-123,67,56,123,Ba,122.918781
La-123,66,57,123,La,122.926300
Ce-123,65,58,123,Ce,122.935280
Pr-123,64,59,123,Pr,122.946080
Ru-124,80,44,124,Ru,123.963940
Rh-124,79,45,124,Rh,123.952000
Pd-124,78,46,124,Pd,123.937310
Ag-124,77,47,124,Ag,123.928900
Cd-124,76,48,124,Cd,123.917659.8
In-124,75,49,124,In,123.913180
Sn-124,74,50,124,Sn,123.905279.6
Sb-124,73,51,124,Sb,123.905937.1
Te-124,72,52,124,Te,123.902818.3
I-124,71,53,124,I,123.906210.3
Xe-124,70,54,124,Xe,123.905885.2
Cs-124,69,55,124,Cs,123.912247
Ba-124,68,56,124,Ba,123.915094
La-124,67,57,124,La,123.924570
Ce-124,66,58,124,Ce,123.930310
Pr-124,65,59,124,Pr,123.942940
Nd-124,64,60,124,Nd,123.951870
Ru-125,81,44,125,Ru,124.969540
Rh-125,80,45,125,Rh,124.955090
Pd-125,79,46,125,Pd,124.942070
Ag-125,78,47,125,Ag,124.930740
Cd-125,77,48,125,Cd,124.921258
In-125,76,49,125,In,124.913673.8
Sn-125,75,50,125,Sn,124.907789.4
Sb-125,74,51,125,Sb,124.905254.3
Te-125,73,52,125,Te,124.904431.2
I-125,72,53,125,I,124.904630.6
Xe-125,71,54,125,Xe,124.906387.6
Cs-125,70,55,125,Cs,124.909726
Ba-125,69,56,125,Ba,124.914472
La-125,68,57,125,La,124.920816
Ce-125,67,58,125,Ce,124.928440
Pr-125,66,59,125,Pr,124.937660
Nd-125,65,60,125,Nd,124.948400
Rh-126,81,45,126,Rh,125.960060
Pd-126,80,46,126,Pd,125.944400
Ag-126,79,47,126,Ag,125.934810
Cd-126,78,48,126,Cd,125.922430.3
In-126,77,49,126,In,125.916468
Sn-126,76,50,126,Sn,125.907659
Sb-126,75,51,126,Sb,125.907250
Te-126,74,52,126,Te,125.903312.1
I-126,73,53,126,I,125.905624
Xe-126,72,54,126,Xe,125.904297.422
Cs-126,71,55,126,Cs,125.909446
Ba-126,70,56,126,Ba,125.911250
La-126,69,57,126,La,125.919510
Ce-126,68,58,126,Ce,125.923970
Pr-126,67,59,126,Pr,125.935240
Nd-126,66,60,126,Nd,125.942690
Pm-126,65,61,126,Pm,125.957330
Rh-127,82,45,127,Rh,126.963790
Pd-127,81,46,127,Pd,126.949310
Ag-127,80,47,127,Ag,126.937040
Cd-127,79,48,127,Cd,126.926203
In-127,78,49,127,In,126.917466
Sn-127,77,50,127,Sn,126.910392
Sb-127,76,51,127,Sb,126.906926
Te-127,75,52,127,Te,126.905227.0
I-127,74,53,127,I,126.904473
Xe-127,73,54,127,Xe,126.905184
Cs-127,72,55,127,Cs,126.907418
Ba-127,71,56,127,Ba,126.911091
La-127,70,57,127,La,126.916375
Ce-127,69,58,127,Ce,126.922730
Pr-127,68,59,127,Pr,126.930710
Nd-127,67,60,127,Nd,126.939980
Pm-127,66,61,127,Pm,126.951360
Rh-128,83,45,128,Rh,127.970650
Pd-128,82,46,128,Pd,127.952350
Ag-128,81,47,128,Ag,127.941270
Cd-128,80,48,128,Cd,127.927817
In-128,79,49,128,In,127.920353.6
Sn-128,78,50,128,Sn,127.910508
Sb-128,77,51,128,Sb,127.909146
Te-128,76,52,128,Te,127.904461.2
I-128,75,53,128,I,127.905809
Xe-128,74,54,128,Xe,127.903530.753
Cs-128,73,55,128,Cs,127.907748
Ba-128,72,56,128,Ba,127.908352.4
La-128,71,57,128,La,127.915590
Ce-128,70,58,128,Ce,127.918910
Pr-128,69,59,128,Pr,127.928790
Nd-128,68,60,128,Nd,127.935020
Pm-128,67,61,128,Pm,127.948230
Sm-128,66,62,128,Sm,127.957970
Pd-129,83,46,129,Pd,128.959330
Ag-129,82,47,129,Ag,128.944320
Cd-129,81,48,129,Cd,128.932236
In-129,80,49,129,In,128.921808.5
Sn-129,79,50,129,Sn,128.913482
Sb-129,78,51,129,Sb,128.909147
Te-129,77,52,129,Te,128.906596.4
I-129,76,53,129,I,128.904984
Xe-129,75,54,129,Xe,128.904780.857
Cs-129,74,55,129,Cs,128.906066
Ba-129,73,56,129,Ba,128.908683
La-129,72,57,129,La,128.912696
Ce-129,71,58,129,Ce,128.918100
Pr-129,70,59,129,Pr,128.925100
Nd-129,69,60,129,Nd,128.933040
Pm-129,68,61,129,Pm,128.942910
Sm-129,67,62,129,Sm,128.954560
Pd-130,84,46,130,Pd,129.964860
Ag-130,83,47,130,Ag,129.950730
Cd-130,82,48,130,Cd,129.934388
In-130,81,49,130,In,129.924952.3
Sn-130,80,50,130,Sn,129.913974.5
Sb-130,79,51,130,Sb,129.911663
Te-130,78,52,130,Te,129.906222.745
I-130,77,53,130,I,129.906670
Xe-130,76,54,130,Xe,129.903509.347
Cs-130,75,55,130,Cs,129.906709
Ba-130,74,56,130,Ba,129.906326.0
La-130,73,57,130,La,129.912369
Ce-130,72,58,130,Ce,129.914740
Pr-130,71,59,130,Pr,129.923590
Nd-130,70,60,130,Nd,129.928510
Pm-130,69,61,130,Pm,129.940450
Sm-130,68,62,130,Sm,129.948790
Eu-130,67,63,130,Eu,129.964020
Pd-131,85,46,131,Pd,130.972370
Ag-131,84,47,131,Ag,130.956250
Cd-131,83,48,131,Cd,130.940728
In-131,82,49,131,In,130.926972.8
Sn-131,81,50,131,Sn,130.917053
Sb-131,80,51,131,Sb,130.911989.3
Te-131,79,52,131,Te,130.908522.21
I-131,78,53,131,I,130.906126.4
Xe-131,77,54,131,Xe,130.905084.128
Cs-131,76,55,131,Cs,130.905468.46
Ba-131,75,56,131,Ba,130.906946.3
La-131,74,57,131,La,130.910070
Ce-131,73,58,131,Ce,130.914430
Pr-131,72,59,131,Pr,130.920230
Nd-131,71,60,131,Nd,130.927248
Pm-131,70,61,131,Pm,130.935830
Sm-131,69,62,131,Sm,130.946020
Eu-131,68,63,131,Eu,130.957630
Ag-132,85,47,132,Ag,131.963070
Cd-132,84,48,132,Cd,131.945820
In-132,83,49,132,In,131.933000
Sn-132,82,50,132,Sn,131.917823.9
Sb-132,81,51,132,Sb,131.914508.0
Te-132,80,52,132,Te,131.908547
I-132,79,53,132,I,131.907994
Xe-132,78,54,132,Xe,131.904155.083
Cs-132,77,55,132,Cs,131.906437.7
Ba-132,76,56,132,Ba,131.905061.2
La-132,75,57,132,La,131.910120
Ce-132,74,58,132,Ce,131.911466
Pr-132,73,59,132,Pr,131.919240
Nd-132,72,60,132,Nd,131.923321
Pm-132,71,61,132,Pm,131.933840
Sm-132,70,62,132,Sm,131.940810
Eu-132,69,63,132,Eu,131.954700
Ag-133,86,47,133,Ag,132.968780
Cd-133,85,48,133,Cd,132.952610
In-133,84,49,133,In,132.938070
Sn-133,83,50,133,Sn,132.923913.8
Sb-133,82,51,133,Sb,132.915272
Te-133,81,52,133,Te,132.910963.3
I-133,80,53,133,I,132.907828
Xe-133,79,54,133,Xe,132.905910.7
Cs-133,78,55,133,Cs,132.905451.959
Ba-133,77,56,133,Ba,132.906007.4
La-133,76,57,133,La,132.908220
Ce-133,75,58,133,Ce,132.911520
Pr-133,74,59,133,Pr,132.916331
Nd-133,73,60,133,Nd,132.922350
Pm-133,72,61,133,Pm,132.929780
Sm-133,71,62,133,Sm,132.938560
Eu-133,70,63,133,Eu,132.949290
Gd-133,69,64,133,Gd,132.961290
Cd-134,86,48,134,Cd,133.957640
In-134,85,49,134,In,133.944210
Sn-134,84,50,134,Sn,133.928680
Sb-134,83,51,134,Sb,133.920537
Te-134,82,52,134,Te,133.911396.4
I-134,81,53,134,I,133.909776
Xe-134,80,54,134,Xe,133.905393.030
Cs-134,79,55,134,Cs,133.906718.502
Ba-134,78,56,134,Ba,133.904508.25
La-134,77,57,134,La,133.908514
Ce-134,76,58,134,Ce,133.908928
Pr-134,75,59,134,Pr,133.915697
Nd-134,74,60,134,Nd,133.918790
Pm-134,73,61,134,Pm,133.928330
Sm-134,72,62,134,Sm,133.934110
Eu-134,71,63,134,Eu,133.946540
Gd-134,70,64,134,Gd,133.955420
Cd-135,87,48,135,Cd,134.964770
In-135,86,49,135,In,134.949430
Sn-135,85,50,135,Sn,134.934909
Sb-135,84,51,135,Sb,134.925184.4
Te-135,83,52,135,Te,134.916554.7
I-135,82,53,135,I,134.910059.4
Xe-135,81,54,135,Xe,134.907231
Cs-135,80,55,135,Cs,134.905976.9
Ba-135,79,56,135,Ba,134.905688.45
La-135,78,57,135,La,134.906984
Ce-135,77,58,135,Ce,134.909161
Pr-135,76,59,135,Pr,134.913112
Nd-135,75,60,135,Nd,134.918181
Pm-135,74,61,135,Pm,134.924790
Sm-135,73,62,135,Sm,134.932520
Eu-135,72,63,135,Eu,134.941870
Gd-135,71,64,135,Gd,134.952500
Tb-135,70,65,135,Tb,134.964520
In-136,87,49,136,In,135.956020
Sn-136,86,50,136,Sn,135.939700
Sb-136,85,51,136,Sb,135.930749
Te-136,84,52,136,Te,135.920101.2
I-136,83,53,136,I,135.914605
Xe-136,82,54,136,Xe,135.907214.474
Cs-136,81,55,136,Cs,135.907311.4
Ba-136,80,56,136,Ba,135.904575.80
La-136,79,57,136,La,135.907630
Ce-136,78,58,136,Ce,135.907129.3
Pr-136,77,59,136,Pr,135.912677
Nd-136,76,60,136,Nd,135.914976
Pm-136,75,61,136,Pm,135.923600
Sm-136,74,62,136,Sm,135.928276
Eu-136,73,63,136,Eu,135.939620
Gd-136,72,64,136,Gd,135.947300
Tb-136,71,65,136,Tb,135.961460
In-137,88,49,137,In,136.961540
Sn-137,87,50,137,Sn,136.946160
Sb-137,86,51,137,Sb,136.935520
Te-137,85,52,137,Te,136.925599.4
I-137,84,53,137,I,136.918028
Xe-137,83,54,137,Xe,136.911557.77
Cs-137,82,55,137,Cs,136.907089.3
Ba-137,81,56,137,Ba,136.905827.21
La-137,80,57,137,La,136.906450.4
Ce-137,79,58,137,Ce,136.907762.4
Pr-137,78,59,137,Pr,136.910679
Nd-137,77,60,137,Nd,136.914563
Pm-137,76,61,137,Pm,136.920480
Sm-137,75,62,137,Sm,136.927010
Eu-137,74,63,137,Eu,136.935431
Gd-137,73,64,137,Gd,136.945020
Tb-137,72,65,137,Tb,136.956020
Sn-138,88,50,138,Sn,137.951140
Sb-138,87,51,138,Sb,137.941330
Te-138,86,52,138,Te,137.929472
I-138,85,53,138,I,137.922726
Xe-138,84,54,138,Xe,137.914146
Cs-138,83,55,138,Cs,137.911017
Ba-138,82,56,138,Ba,137.905247.06
La-138,81,57,138,La,137.907124.0
Ce-138,80,58,138,Ce,137.905994.2
Pr-138,79,59,138,Pr,137.910757
Nd-138,78,60,138,Nd,137.911951
Pm-138,77,61,138,Pm,137.919576
Sm-138,76,62,138,Sm,137.923244
Eu-138,75,63,138,Eu,137.933710
Gd-138,74,64,138,Gd,137.940250
Tb-138,73,65,138,Tb,137.953190
Dy-138,72,66,138,Dy,137.962500
Sn-139,89,50,139,Sn,138.957800
Sb-139,88,51,139,Sb,138.946270
Te-139,87,52,139,Te,138.935367
I-139,86,53,139,I,138.926493
Xe-139,85,54,139,Xe,138.918792.2
Cs-139,84,55,139,Cs,138.913364
Ba-139,83,56,139,Ba,138.908841.16
La-139,82,57,139,La,138.906362.9
Ce-139,81,58,139,Ce,138.906647.0
Pr-139,80,59,139,Pr,138.908933
Nd-139,79,60,139,Nd,138.911951
Pm-139,78,61,139,Pm,138.916799
Sm-139,77,62,139,Sm,138.922297
Eu-139,76,63,139,Eu,138.929792
Gd-139,75,64,139,Gd,138.938130
Tb-139,74,65,139,Tb,138.948330
Dy-139,73,66,139,Dy,138.959530
Sn-140,90,50,140,Sn,139.962970
Sb-140,89,51,140,Sb,139.952350
Te-140,88,52,140,Te,139.939487
I-140,87,53,140,I,139.931716
Xe-140,86,54,140,Xe,139.921645.8
Cs-140,85,55,140,Cs,139.917284
Ba-140,84,56,140,Ba,139.910608
La-140,83,57,140,La,139.909487.3
Ce-140,82,58,140,Ce,139.905448.4
Pr-140,81,59,140,Pr,139.909086
Nd-140,80,60,140,Nd,139.909546
Pm-140,79,61,140,Pm,139.916036
Sm-140,78,62,140,Sm,139.918995
Eu-140,77,63,140,Eu,139.928090
Gd-140,76,64,140,Gd,139.933670
Tb-140,75,65,140,Tb,139.945810
Dy-140,74,66,140,Dy,139.954020
Ho-140,73,67,140,Ho,139.968530
Sb-141,90,51,141,Sb,140.957550
Te-141,89,52,141,Te,140.945600
I-141,88,53,141,I,140.935666
Xe-141,87,54,141,Xe,140.926787
Cs-141,86,55,141,Cs,140.920045
Ba-141,85,56,141,Ba,140.914404
La-141,84,57,141,La,140.910971
Ce-141,83,58,141,Ce,140.908286.0
Pr-141,82,59,141,Pr,140.907659.6
Nd-141,81,60,141,Nd,140.909617
Pm-141,80,61,141,Pm,140.913555
Sm-141,79,62,141,Sm,140.918482
Eu-141,78,63,141,Eu,140.924932
Gd-141,77,64,141,Gd,140.932126
Tb-141,76,65,141,Tb,140.941450
Dy-141,75,66,141,Dy,140.951280
Ho-141,74,67,141,Ho,140.963110
Sb-142,91,51,142,Sb,141.963920
Te-142,90,52,142,Te,141.950030
I-142,89,53,142,I,141.941167
Xe-142,88,54,142,Xe,141.929973.1
Cs-142,87,55,142,Cs,141.924300
Ba-142,86,56,142,Ba,141.916433
La-142,85,57,142,La,141.914091
Ce-142,84,58,142,Ce,141.909250.2
Pr-142,83,59,142,Pr,141.910051.6
Nd-142,82,60,142,Nd,141.907728.8
Pm-142,81,61,142,Pm,141.912891
Sm-142,80,62,142,Sm,141.915209.4
Eu-142,79,63,142,Eu,141.923450
Gd-142,78,64,142,Gd,141.928120
Tb-142,77,65,142,Tb,141.939280
Dy-142,76,66,142,Dy,141.946190
Ho-142,75,67,142,Ho,141.960010
Er-142,74,68,142,Er,141.970020
Te-143,91,52,143,Te,142.956490
I-143,90,53,143,I,142.945480
Xe-143,89,54,143,Xe,142.935370
Cs-143,88,55,143,Cs,142.927347
Ba-143,87,56,143,Ba,142.920625
La-143,86,57,143,La,142.916079
Ce-143,85,58,143,Ce,142.912392.0
Pr-143,84,59,143,Pr,142.910822.6
Nd-143,83,60,143,Nd,142.909819.8
Pm-143,82,61,143,Pm,142.910938
Sm-143,81,62,143,Sm,142.914634.8
Eu-143,80,63,143,Eu,142.920299
Gd-143,79,64,143,Gd,142.926750
Tb-143,78,65,143,Tb,142.935140
Dy-143,77,66,143,Dy,142.943994
Ho-143,76,67,143,Ho,142.954860
Er-143,75,68,143,Er,142.966550
Te-144,92,52,144,Te,143.961120
I-144,91,53,144,I,143.951340
Xe-144,90,54,144,Xe,143.938945
Cs-144,89,55,144,Cs,143.932075
Ba-144,88,56,144,Ba,143.922955
La-144,87,57,144,La,143.919646
Ce-144,86,58,144,Ce,143.913653
Pr-144,85,59,144,Pr,143.913310.7
Nd-144,84,60,144,Nd,143.910092.8
Pm-144,83,61,144,Pm,143.912596
Sm-144,82,62,144,Sm,143.912006.3
Eu-144,81,63,144,Eu,143.918819
Gd-144,80,64,144,Gd,143.922960
Tb-144,79,65,144,Tb,143.933050
Dy-144,78,66,144,Dy,143.939270
Ho-144,77,67,144,Ho,143.952110
Er-144,76,68,144,Er,143.960700
Tm-144,75,69,144,Tm,143.976210
Te-145,93,52,145,Te,144.967780
I-145,92,53,145,I,144.955850
Xe-145,91,54,145,Xe,144.944720
Cs-145,90,55,145,Cs,144.935529
Ba-145,89,56,145,Ba,144.927518
La-145,88,57,145,La,144.921808
Ce-145,87,58,145,Ce,144.917270
Pr-145,86,59,145,Pr,144.914518
Nd-145,85,60,145,Nd,144.912579.2
Pm-145,84,61,145,Pm,144.912756
Sm-145,83,62,145,Sm,144.913417.2
Eu-145,82,63,145,Eu,144.916273
Gd-145,81,64,145,Gd,144.921710
Tb-145,80,65,145,Tb,144.928720
Dy-145,79,66,145,Dy,144.937474
Ho-145,78,67,145,Ho,144.947267
Er-145,77,68,145,Er,144.957870
Tm-145,76,69,145,Tm,144.970390
I-146,93,53,146,I,145.961850
Xe-146,92,54,146,Xe,145.948518
Cs-146,91,55,146,Cs,145.940622
Ba-146,90,56,146,Ba,145.930363.2
La-146,89,57,146,La,145.925688.0
Ce-146,88,58,146,Ce,145.918812
Pr-146,87,59,146,Pr,145.917690
Nd-146,86,60,146,Nd,145.913122.5
Pm-146,85,61,146,Pm,145.914702
Sm-146,84,62,146,Sm,145.913047
Eu-146,83,63,146,Eu,145.917211
Gd-146,82,64,146,Gd,145.918319
Tb-146,81,65,146,Tb,145.927250
Dy-146,80,66,146,Dy,145.932845
Ho-146,79,67,146,Ho,145.944994
Er-146,78,68,146,Er,145.952418
Tm-146,77,69,146,Tm,145.966660
I-147,94,53,147,I,146.966510
Xe-147,93,54,147,Xe,146.954480
Cs-147,92,55,147,Cs,146.944262
Ba-147,91,56,147,Ba,146.935304
La-147,90,57,147,La,146.928418
Ce-147,89,58,147,Ce,146.922690
Pr-147,88,59,147,Pr,146.919007
Nd-147,87,60,147,Nd,146.916106.0
Pm-147,86,61,147,Pm,146.915144.9
Sm-147,85,62,147,Sm,146.914904.4
Eu-147,84,63,147,Eu,146.916752.4
Gd-147,83,64,147,Gd,146.919101.0
Tb-147,82,65,147,Tb,146.924055
Dy-147,81,66,147,Dy,146.931083
Ho-147,80,67,147,Ho,146.940142
Er-147,79,68,147,Er,146.949960
Tm-147,78,69,147,Tm,146.961380
Xe-148,94,54,148,Xe,147.958510
Cs-148,93,55,148,Cs,147.949639
Ba-148,92,56,148,Ba,147.938223.0
La-148,91,57,148,La,147.932679
Ce-148,90,58,148,Ce,147.924424
Pr-148,89,59,148,Pr,147.922130
Nd-148,88,60,148,Nd,147.916899.0
Pm-148,87,61,148,Pm,147.917481
Sm-148,86,62,148,Sm,147.914829.2
Eu-148,85,63,148,Eu,147.918091
Gd-148,84,64,148,Gd,147.918121.4
Tb-148,83,65,148,Tb,147.924275
Dy-148,82,66,148,Dy,147.927150
Ho-148,81,67,148,Ho,147.937740
Er-148,80,68,148,Er,147.944735
Tm-148,79,69,148,Tm,147.958384
Yb-148,78,70,148,Yb,147.967550
Xe-149,95,54,149,Xe,148.964570
Cs-149,94,55,149,Cs,148.953520
Ba-149,93,56,149,Ba,148.943284.0
La-149,92,57,149,La,148.935350
Ce-149,91,58,149,Ce,148.928427
Pr-149,90,59,149,Pr,148.923736
Nd-149,89,60,149,Nd,148.920154.6
Pm-149,88,61,149,Pm,148.918341.5
Sm-149,87,62,149,Sm,148.917191.2
Eu-149,86,63,149,Eu,148.917937
Gd-149,85,64,149,Gd,148.919348
Tb-149,84,65,149,Tb,148.923254
Dy-149,83,66,149,Dy,148.927328
Ho-149,82,67,149,Ho,148.933820
Er-149,81,68,149,Er,148.942310
Tm-149,80,69,149,Tm,148.952830
Yb-149,79,70,149,Yb,148.964220
Xe-150,96,54,150,Xe,149.968880
Cs-150,95,55,150,Cs,149.959020
Ba-150,94,56,150,Ba,149.946441
La-150,93,57,150,La,149.939547.5
Ce-150,92,58,150,Ce,149.930384
Pr-150,91,59,150,Pr,149.926676
Nd-150,90,60,150,Nd,149.920901.3
Pm-150,89,61,150,Pm,149.920990
Sm-150,88,62,150,Sm,149.917282.0
Eu-150,87,63,150,Eu,149.919707
Gd-150,86,64,150,Gd,149.918664
Tb-150,85,65,150,Tb,149.923665
Dy-150,84,66,150,Dy,149.925593
Ho-150,83,67,150,Ho,149.933498
Er-150,82,68,150,Er,149.937916
Tm-150,81,69,150,Tm,149.950090
Yb-150,80,70,150,Yb,149.958310
Lu-150,79,71,150,Lu,149.973410
Cs-151,96,55,151,Cs,150.963200
Ba-151,95,56,151,Ba,150.951760
La-151,94,57,151,La,150.942770
Ce-151,93,58,151,Ce,150.934272
Pr-151,92,59,151,Pr,150.928309
Nd-151,91,60,151,Nd,150.923839.4
Pm-151,90,61,151,Pm,150.921217
Sm-151,89,62,151,Sm,150.919938.9
Eu-151,88,63,151,Eu,150.919856.6
Gd-151,87,64,151,Gd,150.920355
Tb-151,86,65,151,Tb,150.923109
Dy-151,85,66,151,Dy,150.926191
Ho-151,84,67,151,Ho,150.931698
Er-151,83,68,151,Er,150.937449
Tm-151,82,69,151,Tm,150.945494
Yb-151,81,70,151,Yb,150.955400
Lu-151,80,71,151,Lu,150.967470
Cs-152,97,55,152,Cs,151.968730
Ba-152,96,56,152,Ba,151.955330
La-152,95,57,152,La,151.947090
Ce-152,94,58,152,Ce,151.936680
Pr-152,93,59,152,Pr,151.931553
Nd-152,92,60,152,Nd,151.924691
Pm-152,91,61,152,Pm,151.923505
Sm-152,90,62,152,Sm,151.919738.6
Eu-152,89,63,152,Eu,151.921751.0
Gd-152,88,64,152,Gd,151.919798.4
Tb-152,87,65,152,Tb,151.924080
Dy-152,86,66,152,Dy,151.924725
Ho-152,85,67,152,Ho,151.931718
Er-152,84,68,152,Er,151.935050
Tm-152,83,69,152,Tm,151.944480
Yb-152,82,70,152,Yb,151.950330
Lu-152,81,71,152,Lu,151.964120
Ba-153,97,56,153,Ba,152.960850
La-153,96,57,153,La,152.950550
Ce-153,95,58,153,Ce,152.941050
Pr-153,94,59,153,Pr,152.933904
Nd-153,93,60,153,Nd,152.927717.9
Pm-153,92,61,153,Pm,152.924156
Sm-153,91,62,153,Sm,152.922103.6
Eu-153,90,63,153,Eu,152.921236.8
Gd-153,89,64,153,Gd,152.921756.9
Tb-153,88,65,153,Tb,152.923442
Dy-153,87,66,153,Dy,152.925772
Ho-153,86,67,153,Ho,152.930207
Er-153,85,68,153,Er,152.935086
Tm-153,84,69,153,Tm,152.942058
Yb-153,83,70,153,Yb,152.949370
Lu-153,82,71,153,Lu,152.958800
Hf-153,81,72,153,Hf,152.970690
Ba-154,98,56,154,Ba,153.964660
La-154,97,57,154,La,153.955420
Ce-154,96,58,154,Ce,153.943940
Pr-154,95,59,154,Pr,153.937890
Nd-154,94,60,154,Nd,153.929597.4
Pm-154,93,61,154,Pm,153.926713
Sm-154,92,62,154,Sm,153.922215.8
Eu-154,91,63,154,Eu,153.922985.7
Gd-154,90,64,154,Gd,153.920873.0
Tb-154,89,65,154,Tb,153.924680
Dy-154,88,66,154,Dy,153.924429
Ho-154,87,67,154,Ho,153.930607
Er-154,86,68,154,Er,153.932791
Tm-154,85,69,154,Tm,153.941570
Yb-154,84,70,154,Yb,153.946396
Lu-154,83,71,154,Lu,153.957420
Hf-154,82,72,154,Hf,153.964860
La-155,98,57,155,La,154.959280
Ce-155,97,58,155,Ce,154.948710
Pr-155,96,59,155,Pr,154.940509
Nd-155,95,60,155,Nd,154.933136
Pm-155,94,61,155,Pm,154.928137
Sm-155,93,62,155,Sm,154.924646.6
Eu-155,92,63,155,Eu,154.922899.8
Gd-155,91,64,155,Gd,154.922629.4
Tb-155,90,65,155,Tb,154.923510
Dy-155,89,66,155,Dy,154.925758
Ho-155,88,67,155,Ho,154.929103
Er-155,87,68,155,Er,154.933216
Tm-155,86,69,155,Tm,154.939210
Yb-155,85,70,155,Yb,154.945783
Lu-155,84,71,155,Lu,154.954326
Hf-155,83,72,155,Hf,154.963170
Ta-155,82,73,155,Ta,154.974250
La-156,99,57,156,La,155.964520
Ce-156,98,58,156,Ce,155.951880
Pr-156,97,59,156,Pr,155.944766.9
Nd-156,96,60,156,Nd,155.935370.4
Pm-156,95,61,156,Pm,155.931114.1
Sm-156,94,62,156,Sm,155.925538
Eu-156,93,63,156,Eu,155.924763
Gd-156,92,64,156,Gd,155.922130.1
Tb-156,91,65,156,Tb,155.924754
Dy-156,90,66,156,Dy,155.924283.6
Ho-156,89,67,156,Ho,155.929640
Er-156,88,68,156,Er,155.931066
Tm-156,87,69,156,Tm,155.938986
Yb-156,86,70,156,Yb,155.942817
Lu-156,85,71,156,Lu,155.953090
Hf-156,84,72,156,Hf,155.959400
Ta-156,83,73,156,Ta,155.972090
La-157,100,57,157,La,156.968790
Ce-157,99,58,157,Ce,156.957130
Pr-157,98,59,157,Pr,156.948003
Nd-157,97,60,157,Nd,156.939351.1
Pm-157,96,61,157,Pm,156.933121
Sm-157,95,62,157,Sm,156.928419
Eu-157,94,63,157,Eu,156.925433
Gd-157,93,64,157,Gd,156.923967.4
Tb-157,92,65,157,Tb,156.924031.9
Dy-157,91,66,157,Dy,156.925470
Ho-157,90,67,157,Ho,156.928252
Er-157,89,68,157,Er,156.931923
Tm-157,88,69,157,Tm,156.936970
Yb-157,87,70,157,Yb,156.942651
Lu-157,86,71,157,Lu,156.950145
Hf-157,85,72,157,Hf,156.958290
Ta-157,84,73,157,Ta,156.968230
W-157,83,74,157,W,156.978860
Ce-158,100,58,158,Ce,157.960770
Pr-158,99,59,158,Pr,157.952600
Nd-158,98,60,158,Nd,157.942205.6
Pm-158,97,61,158,Pm,157.936546.9
Sm-158,96,62,158,Sm,157.929949
Eu-158,95,63,158,Eu,157.927782.2
Gd-158,94,64,158,Gd,157.924111.2
Tb-158,93,65,158,Tb,157.925419.9
Dy-158,92,66,158,Dy,157.924414.8
Ho-158,91,67,158,Ho,157.928945
Er-158,90,68,158,Er,157.929893
Tm-158,89,69,158,Tm,157.936980
Yb-158,88,70,158,Yb,157.939871
Lu-158,87,71,158,Lu,157.949316
Hf-158,86,72,158,Hf,157.954801
Ta-158,85,73,158,Ta,157.966590
W-158,84,74,158,W,157.974570
Ce-159,101,58,159,Ce,158.966360
Pr-159,100,59,159,Pr,158.956230
Nd-159,99,60,159,Nd,158.946620
Pm-159,98,61,159,Pm,158.939286
Sm-159,97,62,159,Sm,158.933217
Eu-159,96,63,159,Eu,158.929100
Gd-159,95,64,159,Gd,158.926395.8
Tb-159,94,65,159,Tb,158.925353.7
Dy-159,93,66,159,Dy,158.925745.9
Ho-159,92,67,159,Ho,158.927719
Er-159,91,68,159,Er,158.930691
Tm-159,90,69,159,Tm,158.934980
Yb-159,89,70,159,Yb,158.940060
Lu-159,88,71,159,Lu,158.946640
Hf-159,87,72,159,Hf,158.953996
Ta-159,86,73,159,Ta,158.963028
W-159,85,74,159,W,158.972700
Re-159,84,75,159,Re,158.984110
Pr-160,101,59,160,Pr,159.961140
Nd-160,100,60,160,Nd,159.949840
Pm-160,99,61,160,Pm,159.943215.3
Sm-160,98,62,160,Sm,159.935337.0
Eu-160,97,63,160,Eu,159.931837.0
Gd-160,96,64,160,Gd,159.927061.2
Tb-160,95,65,160,Tb,159.927174.6
Dy-160,94,66,160,Dy,159.925203.6
Ho-160,93,67,160,Ho,159.928736
Er-160,92,68,160,Er,159.929077
Tm-160,91,69,160,Tm,159.935260
Yb-160,90,70,160,Yb,159.937559
Lu-160,89,71,160,Lu,159.946030
Hf-160,88,72,160,Hf,159.950683
Ta-160,87,73,160,Ta,159.961540
W-160,86,74,160,W,159.968510
Re-160,85,75,160,Re,159.981880
Pr-161,102,59,161,Pr,160.965120
Nd-161,101,60,161,Nd,160.954660
Pm-161,100,61,161,Pm,160.946230
Sm-161,99,62,161,Sm,160.939160
Eu-161,98,63,161,Eu,160.933664
Gd-161,97,64,161,Gd,160.929676.3
Tb-161,96,65,161,Tb,160.927576.8
Dy-161,95,66,161,Dy,160.926939.4
Ho-161,94,67,161,Ho,160.927861.8
Er-161,93,68,161,Er,160.930004
Tm-161,92,69,161,Tm,160.933550
Yb-161,91,70,161,Yb,160.937912
Lu-161,90,71,161,Lu,160.943570
Hf-161,89,72,161,Hf,160.950278
Ta-161,88,73,161,Ta,160.958369
W-161,87,74,161,W,160.967250
Re-161,86,75,161,Re,160.977620
Os-161,85,76,161,Os,160.989050
Nd-162,102,60,162,Nd,161.958120
Pm-162,101,61,162,Pm,161.950570
Sm-162,100,62,162,Sm,161.941622
Eu-162,99,63,162,Eu,161.936958.3
Gd-162,98,64,162,Gd,161.930992
Tb-162,97,65,162,Tb,161.929275.4
Dy-162,96,66,162,Dy,161.926804.5
Ho-162,95,67,162,Ho,161.929103
Er-162,94,68,162,Er,161.928787.3
Tm-162,93,69,162,Tm,161.934001
Yb-162,92,70,162,Yb,161.935779
Lu-162,91,71,162,Lu,161.943280
Hf-162,90,72,162,Hf,161.947216
Ta-162,89,73,162,Ta,161.957290
W-162,88,74,162,W,161.963500
Re-162,87,75,162,Re,161.975900
Os-162,86,76,162,Os,161.984430
Nd-163,103,60,163,Nd,162.963410
Pm-163,102,61,163,Pm,162.953880
Sm-163,101,62,163,Sm,162.945679
Eu-163,100,63,163,Eu,162.939265.5
Gd-163,99,64,163,Gd,162.934096.6
Tb-163,98,65,163,Tb,162.930654
Dy-163,97,66,163,Dy,162.928737.2
Ho-163,96,67,163,Ho,162.928740.3
Er-163,95,68,163,Er,162.930040
Tm-163,94,69,163,Tm,162.932658
Yb-163,93,70,163,Yb,162.936345
Lu-163,92,71,163,Lu,162.941180
Hf-163,91,72,163,Hf,162.947107
Ta-163,90,73,163,Ta,162.954340
W-163,89,74,163,W,162.962520
Re-163,88,75,163,Re,162.972085
Os-163,87,76,163,Os,162.982460
Ir-163,86,77,163,Ir,162.994300
Pm-164,103,61,164,Pm,163.958820
Sm-164,102,62,164,Sm,163.948550
Eu-164,101,63,164,Eu,163.942852.9
Gd-164,100,64,164,Gd,163.935916.2
Tb-164,99,65,164,Tb,163.933327.6
Dy-164,98,66,164,Dy,163.929180.8
Ho-164,97,67,164,Ho,163.930240.5
Er-164,96,68,164,Er,163.929207.7
Tm-164,95,69,164,Tm,163.933538
Yb-164,94,70,164,Yb,163.934501
Lu-164,93,71,164,Lu,163.941340
Hf-164,92,72,164,Hf,163.944371
Ta-164,91,73,164,Ta,163.953530
W-164,90,74,164,W,163.958952
Re-164,89,75,164,Re,163.970510
Os-164,88,76,164,Os,163.978070
Ir-164,87,77,164,Ir,163.991970
Pm-165,104,61,165,Pm,164.962780
Sm-165,103,62,165,Sm,164.953290
Eu-165,102,63,165,Eu,164.945540
Gd-165,101,64,165,Gd,164.939317.1
Tb-165,100,65,165,Tb,164.934955.2
Dy-165,99,66,165,Dy,164.931709.4
Ho-165,98,67,165,Ho,164.930329.1
Er-165,97,68,165,Er,164.930733.5
Tm-165,96,69,165,Tm,164.932441.8
Yb-165,95,70,165,Yb,164.935270
Lu-165,94,71,165,Lu,164.939407
Hf-165,93,72,165,Hf,164.944570
Ta-165,92,73,165,Ta,164.950780
W-165,91,74,165,W,164.958281
Re-165,90,75,165,Re,164.967086
Os-165,89,76,165,Os,164.976650
Ir-165,88,77,165,Ir,164.987550
Pt-165,87,78,165,Pt,164.999660
Sm-166,104,62,166,Sm,165.956580
Eu-166,103,63,166,Eu,165.949810
Gd-166,102,64,166,Gd,165.941630.4
Tb-166,101,65,166,Tb,165.937939.7
Dy-166,100,66,166,Dy,165.932812.8
Ho-166,99,67,166,Ho,165.932291.2
Er-166,98,68,166,Er,165.930301.1
Tm-166,97,69,166,Tm,165.933562
Yb-166,96,70,166,Yb,165.933876
Lu-166,95,71,166,Lu,165.939860
Hf-166,94,72,166,Hf,165.942180
Ta-166,93,73,166,Ta,165.950510
W-166,92,74,166,W,165.955032
Re-166,91,75,166,Re,165.965820
Os-166,90,76,166,Os,165.972698
Ir-166,89,77,166,Ir,165.985720
Pt-166,88,78,166,Pt,165.994870
Sm-167,105,62,167,Sm,166.962070
Eu-167,104,63,167,Eu,166.953010
Gd-167,103,64,167,Gd,166.945490
Tb-167,102,65,167,Tb,166.940007.0
Dy-167,101,66,167,Dy,166.935682
Ho-167,100,67,167,Ho,166.933140
Er-167,99,68,167,Er,166.932056.2
Tm-167,98,69,167,Tm,166.932857.2
Yb-167,97,70,167,Yb,166.934954
Lu-167,96,71,167,Lu,166.938240
Hf-167,95,72,167,Hf,166.942600
Ta-167,94,73,167,Ta,166.948090
W-167,93,74,167,W,166.954811
Re-167,92,75,167,Re,166.962600
Os-167,91,76,167,Os,166.971550
Ir-167,90,77,167,Ir,166.981672
Pt-167,89,78,167,Pt,166.992750
Sm-168,106,62,168,Sm,167.966030
Eu-168,105,63,168,Eu,167.957860
Gd-168,104,64,168,Gd,167.948310
Tb-168,103,65,168,Tb,167.943337
Dy-168,102,66,168,Dy,167.937130
Ho-168,101,67,168,Ho,167.935520
Er-168,100,68,168,Er,167.932378.28
Tm-168,99,69,168,Tm,167.934178.5
Yb-168,98,70,168,Yb,167.933891.30
Lu-168,97,71,168,Lu,167.938730
Hf-168,96,72,168,Hf,167.940570
Ta-168,95,73,168,Ta,167.948050
W-168,94,74,168,W,167.951805
Re-168,93,75,168,Re,167.961570
Os-168,92,76,168,Os,167.967799
Ir-168,91,77,168,Ir,167.979960
Pt-168,90,78,168,Pt,167.988180
Au-168,89,79,168,Au,168.002720
Eu-169,106,63,169,Eu,168.961720
Gd-169,105,64,169,Gd,168.952880
Tb-169,104,65,169,Tb,168.945810
Dy-169,103,66,169,Dy,168.940320
Ho-169,102,67,169,Ho,168.936880
Er-169,101,68,169,Er,168.934598.4
Tm-169,100,69,169,Tm,168.934219.0
Yb-169,99,70,169,Yb,168.935184.21
Lu-169,98,71,169,Lu,168.937646
Hf-169,97,72,169,Hf,168.941260
Ta-169,96,73,169,Ta,168.946010
W-169,95,74,169,W,168.951779
Re-169,94,75,169,Re,168.958766
Os-169,93,76,169,Os,168.967018
Ir-169,92,77,169,Ir,168.976282
Pt-169,91,78,169,Pt,168.986620
Au-169,90,79,169,Au,168.998080
Eu-170,107,63,170,Eu,169.966870
Gd-170,106,64,170,Gd,169.956150
Tb-170,105,65,170,Tb,169.949860
Dy-170,104,66,170,Dy,169.942340
Ho-170,103,67,170,Ho,169.939630
Er-170,102,68,170,Er,169.935471.9
Tm-170,101,69,170,Tm,169.935807.1
Yb-170,100,70,170,Yb,169.934767.243
Lu-170,99,71,170,Lu,169.938479
Hf-170,98,72,170,Hf,169.939610
Ta-170,97,73,170,Ta,169.946180
W-170,96,74,170,W,169.949231
Re-170,95,75,170,Re,169.958235
Os-170,94,76,170,Os,169.963579
Ir-170,93,77,170,Ir,169.975110
Pt-170,92,78,170,Pt,169.982502
Au-170,91,79,170,Au,169.996020
Hg-170,90,80,170,Hg,170.005810
Gd-171,107,64,171,Gd,170.961130
Tb-171,106,65,171,Tb,170.953010
Dy-171,105,66,171,Dy,170.946310
Ho-171,104,67,171,Ho,170.941470
Er-171,103,68,171,Er,170.938037.4
Tm-171,102,69,171,Tm,170.936435.2
Yb-171,101,70,171,Yb,170.936331.515
Lu-171,100,71,171,Lu,170.937918.6
Hf-171,99,72,171,Hf,170.940490
Ta-171,98,73,171,Ta,170.944480
W-171,97,74,171,W,170.949450
Re-171,96,75,171,Re,170.955720
Os-171,95,76,171,Os,170.963180
Ir-171,94,77,171,Ir,170.971650
Pt-171,93,78,171,Pt,170.981250
Au-171,92,79,171,Au,170.991882
Hg-171,91,80,171,Hg,171.003590
Gd-172,108,64,172,Gd,171.964610
Tb-172,107,65,172,Tb,171.957390
Dy-172,106,66,172,Dy,171.948730
Ho-172,105,67,172,Ho,171.944730
Er-172,104,68,172,Er,171.939363
Tm-172,103,69,172,Tm,171.938407
Yb-172,102,70,172,Yb,171.936386.654
Lu-172,101,71,172,Lu,171.939091.3
Hf-172,100,72,172,Hf,171.939450
Ta-172,99,73,172,Ta,171.944900
W-172,98,74,172,W,171.947290
Re-172,97,75,172,Re,171.955380
Os-172,96,76,172,Os,171.960017
Ir-172,95,77,172,Ir,171.970610
Pt-172,94,78,172,Pt,171.977341
Au-172,93,79,172,Au,171.990000
Hg-172,92,80,172,Hg,171.998860
Tb-173,108,65,173,Tb,172.960810
Dy-173,107,66,173,Dy,172.953040
Ho-173,106,67,173,Ho,172.947020
Er-173,105,68,173,Er,172.942400
Tm-173,104,69,173,Tm,172.939607
Yb-173,103,70,173,Yb,172.938216.212
Lu-173,102,71,173,Lu,172.938935.7
Hf-173,101,72,173,Hf,172.940510
Ta-173,100,73,173,Ta,172.943750
W-173,99,74,173,W,172.947690
Re-173,98,75,173,Re,172.953240
Os-173,97,76,173,Os,172.959808
Ir-173,96,77,173,Ir,172.967505
Pt-173,95,78,173,Pt,172.976450
Au-173,94,79,173,Au,172.986224
Hg-173,93,80,173,Hg,172.997140
Tb-174,109,65,174,Tb,173.965680
Dy-174,108,66,174,Dy,173.955850
Ho-174,107,67,174,Ho,173.950760
Er-174,106,68,174,Er,173.944230
Tm-174,105,69,174,Tm,173.942170
Yb-174,104,70,174,Yb,173.938867.546
Lu-174,103,71,174,Lu,173.940342.8
Hf-174,102,72,174,Hf,173.940048.4
Ta-174,101,73,174,Ta,173.944450
W-174,100,74,174,W,173.946080
Re-174,99,75,174,Re,173.953120
Os-174,98,76,174,Os,173.957063
Ir-174,97,77,174,Ir,173.966950
Pt-174,96,78,174,Pt,173.972820
Au-174,95,79,174,Au,173.984910
Hg-174,94,80,174,Hg,173.992871
Dy-175,109,66,175,Dy,174.960570
Ho-175,108,67,175,Ho,174.953520
Er-175,107,68,175,Er,174.947770
Tm-175,106,69,175,Tm,174.943840
Yb-175,105,70,175,Yb,174.941281.91
Lu-175,104,71,175,Lu,174.940777.2
Hf-175,103,72,175,Hf,174.941511.4
Ta-175,102,73,175,Ta,174.943740
W-175,101,74,175,W,174.946720
Re-175,100,75,175,Re,174.951380
Os-175,99,76,175,Os,174.956945
Ir-175,98,77,175,Ir,174.964150
Pt-175,97,78,175,Pt,174.972401
Au-175,96,79,175,Au,174.981320
Hg-175,95,80,175,Hg,174.991440
Dy-176,110,66,176,Dy,175.963920
Ho-176,109,67,176,Ho,175.957710
Er-176,108,68,176,Er,175.949940
Tm-176,107,69,176,Tm,175.947000
Yb-176,106,70,176,Yb,175.942574.706
Lu-176,105,71,176,Lu,175.942691.7
Hf-176,104,72,176,Hf,175.941409.8
Ta-176,103,73,176,Ta,175.944860
W-176,102,74,176,W,175.945630
Re-176,101,75,176,Re,175.951620
Os-176,100,76,176,Os,175.954770
Ir-176,99,77,176,Ir,175.963626
Pt-176,98,78,176,Pt,175.968938
Au-176,97,79,176,Au,175.980120
Hg-176,96,80,176,Hg,175.987349
Tl-176,95,81,176,Tl,176.000630
Ho-177,110,67,177,Ho,176.961050
Er-177,109,68,177,Er,176.953990
Tm-177,108,69,177,Tm,176.948930
Yb-177,107,70,177,Yb,176.945263.85
Lu-177,106,71,177,Lu,176.943763.6
Hf-177,105,72,177,Hf,176.943230.2
Ta-177,104,73,177,Ta,176.944482
W-177,103,74,177,W,176.946640
Re-177,102,75,177,Re,176.950330
Os-177,101,76,177,Os,176.954958
Ir-177,100,77,177,Ir,176.961302
Pt-177,99,78,177,Pt,176.968470
Au-177,98,79,177,Au,176.976870
Hg-177,97,80,177,Hg,176.986280
Tl-177,96,81,177,Tl,176.996414
Ho-178,111,67,178,Ho,177.965510
Er-178,110,68,178,Er,177.956780
Tm-178,109,69,178,Tm,177.952510
Yb-178,108,70,178,Yb,177.946669
Lu-178,107,71,178,Lu,177.945960.1
Hf-178,106,72,178,Hf,177.943708.3
Ta-178,105,73,178,Ta,177.945680
W-178,104,74,178,W,177.945886
Re-178,103,75,178,Re,177.950990
Os-178,102,76,178,Os,177.953253
Ir-178,101,77,178,Ir,177.961079
Pt-178,100,78,178,Pt,177.965649
Au-178,99,79,178,Au,177.976057
Hg-178,98,80,178,Hg,177.982485
Tl-178,97,81,178,Tl,177.995050
Pb-178,96,82,178,Pb,178.003836
Er-179,111,68,179,Er,178.961270
Tm-179,110,69,179,Tm,178.955020
Yb-179,109,70,179,Yb,178.949930
Lu-179,108,71,179,Lu,178.947333
Hf-179,107,72,179,Hf,178.945825.7
Ta-179,106,73,179,Ta,178.945939.1
W-179,105,74,179,W,178.947079
Re-179,104,75,179,Re,178.949990
Os-179,103,76,179,Os,178.953816
Ir-179,102,77,179,Ir,178.959118
Pt-179,101,78,179,Pt,178.965359
Au-179,100,79,179,Au,178.973174
Hg-179,99,80,179,Hg,178.981820
Tl-179,98,81,179,Tl,178.991120
Pb-179,97,82,179,Pb,179.002200
Er-180,112,68,180,Er,179.964380
Tm-180,111,69,180,Tm,179.959020
Yb-180,110,70,180,Yb,179.951990
Lu-180,109,71,180,Lu,179.949890
Hf-180,108,72,180,Hf,179.946559.5
Ta-180,107,73,180,Ta,179.947467.6
W-180,106,74,180,W,179.946713.3
Re-180,105,75,180,Re,179.950792
Os-180,104,76,180,Os,179.952382
Ir-180,103,77,180,Ir,179.959229
Pt-180,102,78,180,Pt,179.963038
Au-180,101,79,180,Au,179.972490
Hg-180,100,80,180,Hg,179.978260
Tl-180,99,81,180,Tl,179.989920
Pb-180,98,82,180,Pb,179.997916
Tm-181,112,69,181,Tm,180.961950
Yb-181,111,70,181,Yb,180.955890
Lu-181,110,71,181,Lu,180.951910
Hf-181,109,72,181,Hf,180.949110.8
Ta-181,108,73,181,Ta,180.947998.5
W-181,107,74,181,W,180.948218.7
Re-181,106,75,181,Re,180.950062
Os-181,105,76,181,Os,180.953247
Ir-181,104,77,181,Ir,180.957635
Pt-181,103,78,181,Pt,180.963090
Au-181,102,79,181,Au,180.970079
Hg-181,101,80,181,Hg,180.977819
Tl-181,100,81,181,Tl,180.986260
Pb-181,99,82,181,Pb,180.996660
Tm-182,113,69,182,Tm,181.966190
Yb-182,112,70,182,Yb,181.958240
Lu-182,111,71,182,Lu,181.955160
Hf-182,110,72,182,Hf,181.950564
Ta-182,109,73,182,Ta,181.950154.6
W-182,108,74,182,W,181.948205.6
Re-182,107,75,182,Re,181.951210
Os-182,106,76,182,Os,181.952110
Ir-182,105,77,182,Ir,181.958076
Pt-182,104,78,182,Pt,181.961172
Au-182,103,79,182,Au,181.969614
Hg-182,102,80,182,Hg,181.974689
Tl-182,101,81,182,Tl,181.985693
Pb-182,100,82,182,Pb,181.992674
Yb-183,113,70,183,Yb,182.962430
Lu-183,112,71,183,Lu,182.957360
Hf-183,111,72,183,Hf,182.953530
Ta-183,110,73,183,Ta,182.951375.4
W-183,109,74,183,W,182.950224.4
Re-183,108,75,183,Re,182.950821
Os-183,107,76,183,Os,182.953130
Ir-183,106,77,183,Ir,182.956841
Pt-183,105,78,183,Pt,182.961596
Au-183,104,79,183,Au,182.967588
Hg-183,103,80,183,Hg,182.974445
Tl-183,102,81,183,Tl,182.982193
Pb-183,101,82,183,Pb,182.991860
Yb-184,114,70,184,Yb,183.965000
Lu-184,113,71,184,Lu,183.961030
Hf-184,112,72,184,Hf,183.955450
Ta-184,111,73,184,Ta,183.954010
W-184,110,74,184,W,183.950933.2
Re-184,109,75,184,Re,183.952528
Os-184,108,76,184,Os,183.952492.9
Ir-184,107,77,184,Ir,183.957480
Pt-184,106,78,184,Pt,183.959922
Au-184,105,79,184,Au,183.967452
Hg-184,104,80,184,Hg,183.971718
Tl-184,103,81,184,Tl,183.981875
Pb-184,102,82,184,Pb,183.988136
Bi-184,101,83,184,Bi,184.001350
Yb-185,115,70,185,Yb,184.969430
Lu-185,114,71,185,Lu,184.963540
Hf-185,113,72,185,Hf,184.958860
Ta-185,112,73,185,Ta,184.955561
W-185,111,74,185,W,184.953421.2
Re-185,110,75,185,Re,184.952958.3
Os-185,109,76,185,Os,184.954046.0
Ir-185,108,77,185,Ir,184.956700
Pt-185,107,78,185,Pt,184.960614
Au-185,106,79,185,Au,184.965798.9
Hg-185,105,80,185,Hg,184.971891
Tl-185,104,81,185,Tl,184.978789
Pb-185,103,82,185,Pb,184.987610
Bi-185,102,83,185,Bi,184.997600
Lu-186,115,71,186,Lu,185.967450
Hf-186,114,72,186,Hf,185.960900
Ta-186,113,73,186,Ta,185.958550
W-186,112,74,186,W,185.954365.1
Re-186,111,75,186,Re,185.954989.2
Os-186,110,76,186,Os,185.953837.6
Ir-186,109,77,186,Ir,185.957947
Pt-186,108,78,186,Pt,185.959351
Au-186,107,79,186,Au,185.965953
Hg-186,106,80,186,Hg,185.969362
Tl-186,105,81,186,Tl,185.978655
Pb-186,104,82,186,Pb,185.984239
Bi-186,103,83,186,Bi,185.996623
Po-186,102,84,186,Po,186.004403
Lu-187,116,71,187,Lu,186.970190
Hf-187,115,72,187,Hf,186.964570
Ta-187,114,73,187,Ta,186.960390
W-187,113,74,187,W,186.957161.2
Re-187,112,75,187,Re,186.955752.2
Os-187,111,76,187,Os,186.955749.6
Ir-187,110,77,187,Ir,186.957540
Pt-187,109,78,187,Pt,186.960617
Au-187,108,79,187,Au,186.964542
Hg-187,107,80,187,Hg,186.969814
Tl-187,106,81,187,Tl,186.975905
Pb-187,105,82,187,Pb,186.983911
Bi-187,104,83,187,Bi,186.993147
Po-187,103,84,187,Po,187.003030
Lu-188,117,71,188,Lu,187.974430
Hf-188,116,72,188,Hf,187.966900
Ta-188,115,73,188,Ta,187.963600
W-188,114,74,188,W,187.958488
Re-188,113,75,188,Re,187.958113.7
Os-188,112,76,188,Os,187.955837.3
Ir-188,111,77,188,Ir,187.958835
Pt-188,110,78,188,Pt,187.959398
Au-188,109,79,188,Au,187.965248.0
Hg-188,108,80,188,Hg,187.967581
Tl-188,107,81,188,Tl,187.976020
Pb-188,106,82,188,Pb,187.980879
Bi-188,105,83,188,Bi,187.992276
Po-188,104,84,188,Po,187.999416
Hf-189,117,72,189,Hf,188.970850
Ta-189,116,73,189,Ta,188.965690
W-189,115,74,189,W,188.961560
Re-189,114,75,189,Re,188.959228
Os-189,113,76,189,Os,188.958145.9
Ir-189,112,77,189,Ir,188.958723
Pt-189,111,78,189,Pt,188.960848
Au-189,110,79,189,Au,188.963948
Hg-189,109,80,189,Hg,188.968190
Tl-189,108,81,189,Tl,188.973574
Pb-189,107,82,189,Pb,188.980844
Bi-189,106,83,189,Bi,188.989195
Po-189,105,84,189,Po,188.998473
Hf-190,118,72,190,Hf,189.973380
Ta-190,117,73,190,Ta,189.969170
W-190,116,74,190,W,189.963100
Re-190,115,75,190,Re,189.961800
Os-190,114,76,190,Os,189.958445.4
Ir-190,113,77,190,Ir,189.960543.4
Pt-190,112,78,190,Pt,189.959949.8
Au-190,111,79,190,Au,189.964752
Hg-190,110,80,190,Hg,189.966322
Tl-190,109,81,190,Tl,189.973842
Pb-190,108,82,190,Pb,189.978082
Bi-190,107,83,190,Bi,189.988625
Po-190,106,84,190,Po,189.995102
Ta-191,118,73,191,Ta,190.971530
W-191,117,74,191,W,190.966530
Re-191,116,75,191,Re,190.963123
Os-191,115,76,191,Os,190.960928.1
Ir-191,114,77,191,Ir,190.960591.5
Pt-191,113,78,191,Pt,190.961676
Au-191,112,79,191,Au,190.963716
Hg-191,111,80,191,Hg,190.967158
Tl-191,110,81,191,Tl,190.971784
Pb-191,109,82,191,Pb,190.978216
Bi-191,108,83,191,Bi,190.985787
Po-191,107,84,191,Po,190.994558
At-191,106,85,191,At,191.004148
Ta-192,119,73,192,Ta,191.975200
W-192,118,74,192,W,191.968200
Re-192,117,75,192,Re,191.966090
Os-192,116,76,192,Os,191.961478.8
Ir-192,115,77,192,Ir,191.962602.4
Pt-192,114,78,192,Pt,191.961042.7
Au-192,113,79,192,Au,191.964818
Hg-192,112,80,192,Hg,191.965634
Tl-192,111,81,192,Tl,191.972230
Pb-192,110,82,192,Pb,191.975790
Bi-192,109,83,192,Bi,191.985470
Po-192,108,84,192,Po,191.991340
At-192,107,85,192,At,192.003141
Ta-193,120,73,193,Ta,192.977660
W-193,119,74,193,W,192.971880
Re-193,118,75,193,Re,192.967550
Os-193,117,76,193,Os,192.964149.6
Ir-193,116,77,193,Ir,192.962923.8
Pt-193,115,78,193,Pt,192.962984.5
Au-193,114,79,193,Au,192.964138
Hg-193,113,80,193,Hg,192.966653
Tl-193,112,81,193,Tl,192.970502
Pb-193,111,82,193,Pb,192.976136
Bi-193,110,83,193,Bi,192.982947
Po-193,109,84,193,Po,192.991062
At-193,108,85,193,At,192.999928
Rn-193,107,86,193,Rn,193.009708
Ta-194,121,73,194,Ta,193.981610
W-194,120,74,194,W,193.973800
Re-194,119,75,194,Re,193.970740
Os-194,118,76,194,Os,193.965179.4
Ir-194,117,77,194,Ir,193.965075.7
Pt-194,116,78,194,Pt,193.962683.5
Au-194,115,79,194,Au,193.965419.1
Hg-194,114,80,194,Hg,193.965449
Tl-194,113,81,194,Tl,193.971081
Pb-194,112,82,194,Pb,193.974012
Bi-194,111,83,194,Bi,193.982799
Po-194,110,84,194,Po,193.988186
At-194,109,85,194,At,193.999231
Rn-194,108,86,194,Rn,194.006146
W-195,121,74,195,W,194.977740
Re-195,120,75,195,Re,194.972560
Os-195,119,76,195,Os,194.968320
Ir-195,118,77,195,Ir,194.965976.9
Pt-195,117,78,195,Pt,194.964794.3
Au-195,116,79,195,Au,194.965037.8
Hg-195,115,80,195,Hg,194.966706
Tl-195,114,81,195,Tl,194.969774
Pb-195,113,82,195,Pb,194.974516
Bi-195,112,83,195,Bi,194.980649
Po-195,111,84,195,Po,194.988066
At-195,110,85,195,At,194.996274
Rn-195,109,86,195,Rn,195.005420
W-196,122,74,196,W,195.979880
Re-196,121,75,196,Re,195.976000
Os-196,120,76,196,Os,195.969640
Ir-196,119,77,196,Ir,195.968400
Pt-196,118,78,196,Pt,195.964954.6
Au-196,117,79,196,Au,195.966571
Hg-196,116,80,196,Hg,195.965833
Tl-196,115,81,196,Tl,195.970481
Pb-196,114,82,196,Pb,195.972788
Bi-196,113,83,196,Bi,195.980667
Po-196,112,84,196,Po,195.985541
At-196,111,85,196,At,195.995800
Rn-196,110,86,196,Rn,196.002120
W-197,123,74,197,W,196.984040
Re-197,122,75,197,Re,196.978150
Os-197,121,76,197,Os,196.973080
Ir-197,120,77,197,Ir,196.969657
Pt-197,119,78,197,Pt,196.967343.0
Au-197,118,79,197,Au,196.966570.1
Hg-197,117,80,197,Hg,196.967214
Tl-197,116,81,197,Tl,196.969560
Pb-197,115,82,197,Pb,196.973435
Bi-197,114,83,197,Bi,196.978865
Po-197,113,84,197,Po,196.985622
At-197,112,85,197,At,196.993177
Rn-197,111,86,197,Rn,197.001621
Fr-197,110,87,197,Fr,197.011010
Re-198,123,75,198,Re,197.981760
Os-198,122,76,198,Os,197.974660
Ir-198,121,77,198,Ir,197.972400
Pt-198,120,78,198,Pt,197.967896.7
Au-198,119,79,198,Au,197.968243.7
Hg-198,118,80,198,Hg,197.966769.2
Tl-198,117,81,198,Tl,197.970447
Pb-198,116,82,198,Pb,197.972015
Bi-198,115,83,198,Bi,197.979201
Po-198,114,84,198,Po,197.983389
At-198,113,85,198,At,197.992798
Rn-198,112,86,198,Rn,197.998679
Fr-198,111,87,198,Fr,198.010280
Re-199,124,75,199,Re,198.984190
Os-199,123,76,199,Os,198.978240
Ir-199,122,77,199,Ir,198.973810
Pt-199,121,78,199,Pt,198.970597.0
Au-199,120,79,199,Au,198.968766.6
Hg-199,119,80,199,Hg,198.968281.0
Tl-199,118,81,199,Tl,198.969880
Pb-199,117,82,199,Pb,198.972913
Bi-199,116,83,199,Bi,198.977673
Po-199,115,84,199,Po,198.983640
At-199,114,85,199,At,198.990528
Rn-199,113,86,199,Rn,198.998325
Fr-199,112,87,199,Fr,199.007269
Os-200,124,76,200,Os,199.980090
Ir-200,123,77,200,Ir,199.976840
Pt-200,122,78,200,Pt,199.971445
Au-200,121,79,200,Au,199.970757
Hg-200,120,80,200,Hg,199.968326.9
Tl-200,119,81,200,Tl,199.970964
Pb-200,118,82,200,Pb,199.971819
Bi-200,117,83,200,Bi,199.978131
Po-200,116,84,200,Po,199.981812
At-200,115,85,200,At,199.990351
Rn-200,114,86,200,Rn,199.995705
Fr-200,113,87,200,Fr,200.006580
Os-201,125,76,201,Os,200.984070
Ir-201,124,77,201,Ir,200.978700
Pt-201,123,78,201,Pt,200.974510
Au-201,122,79,201,Au,200.971658
Hg-201,121,80,201,Hg,200.970303.1
Tl-201,120,81,201,Tl,200.970820
Pb-201,119,82,201,Pb,200.972870
Bi-201,118,83,201,Bi,200.976995
Po-201,117,84,201,Po,200.982264
At-201,116,85,201,At,200.988417
Rn-201,115,86,201,Rn,200.995591
Fr-201,114,87,201,Fr,201.003852
Ra-201,113,88,201,Ra,201.012815
Os-202,126,76,202,Os,201.986550
Ir-202,125,77,202,Ir,201.982140
Pt-202,124,78,202,Pt,201.975639
Au-202,123,79,202,Au,201.973856
Hg-202,122,80,202,Hg,201.970643.6
Tl-202,121,81,202,Tl,201.972108.9
Pb-202,120,82,202,Pb,201.972152
Bi-202,119,83,202,Bi,201.977723
Po-202,118,84,202,Po,201.980739
At-202,117,85,202,At,201.988626
Rn-202,116,86,202,Rn,201.993264
Fr-202,115,87,202,Fr,202.003330
Ra-202,114,88,202,Ra,202.009742
Os-203,127,76,203,Os,202.992200
Ir-203,126,77,203,Ir,202.984570
Pt-203,125,78,203,Pt,202.979060
Au-203,124,79,203,Au,202.975154
Hg-203,123,80,203,Hg,202.972872.4
Tl-203,122,81,203,Tl,202.972344.1
Pb-203,121,82,203,Pb,202.973391
Bi-203,120,83,203,Bi,202.976892
Po-203,119,84,203,Po,202.981416
At-203,118,85,203,At,202.986943
Rn-203,117,86,203,Rn,202.993361
Fr-203,116,87,203,Fr,203.000941
Ra-203,115,88,203,Ra,203.009234
Ir-204,127,77,204,Ir,203.989730
Pt-204,126,78,204,Pt,203.981080
Au-204,125,79,204,Au,203.978110
Hg-204,124,80,204,Hg,203.973494.0
Tl-204,123,81,204,Tl,203.973863.4
Pb-204,122,82,204,Pb,203.973043.5
Bi-204,121,83,204,Bi,203.977836
Po-204,120,84,204,Po,203.980310
At-204,119,85,204,At,203.987251
Rn-204,118,86,204,Rn,203.991444
Fr-204,117,87,204,Fr,204.000652
Ra-204,116,88,204,Ra,204.006507
Ir-205,128,77,205,Ir,204.993990
Pt-205,127,78,205,Pt,204.986240
Au-205,126,79,205,Au,204.980060
Hg-205,125,80,205,Hg,204.976073
Tl-205,124,81,205,Tl,204.974427.3
Pb-205,123,82,205,Pb,204.974481.7
Bi-205,122,83,205,Bi,204.977385
Po-205,121,84,205,Po,204.981190
At-205,120,85,205,At,204.986061
Rn-205,119,86,205,Rn,204.991723
Fr-205,118,87,205,Fr,204.998594
Ra-205,117,88,205,Ra,205.006231
Ac-205,116,89,205,Ac,205.015140
Pt-206,128,78,206,Pt,205.990080
Au-206,127,79,206,Au,205.984770
Hg-206,126,80,206,Hg,205.977514
Tl-206,125,81,206,Tl,205.976110.1
Pb-206,124,82,206,Pb,205.974465.2
Bi-206,123,83,206,Bi,205.978499
Po-206,122,84,206,Po,205.980474
At-206,121,85,206,At,205.986646
Rn-206,120,86,206,Rn,205.990195
Fr-206,119,87,206,Fr,205.998661
Ra-206,118,88,206,Ra,206.003828
Ac-206,117,89,206,Ac,206.014480
Pt-207,129,78,207,Pt,206.995560
Au-207,128,79,207,Au,206.988580
Hg-207,127,80,207,Hg,206.982300
Tl-207,126,81,207,Tl,206.977419
Pb-207,125,82,207,Pb,206.975896.8
Bi-207,124,83,207,Bi,206.978470.6
Po-207,123,84,207,Po,206.981593
At-207,122,85,207,At,206.985800
Rn-207,121,86,207,Rn,206.990730
Fr-207,120,87,207,Fr,206.996941
Ra-207,119,88,207,Ra,207.003770
Ac-207,118,89,207,Ac,207.011970
Pt-208,130,78,208,Pt,207.999460
Au-208,129,79,208,Au,207.993660
Hg-208,128,80,208,Hg,207.985760
Tl-208,127,81,208,Tl,207.982018.0
Pb-208,126,82,208,Pb,207.976652.0
Bi-208,125,83,208,Bi,207.979742.1
Po-208,124,84,208,Po,207.981246.0
At-208,123,85,208,At,207.986613
Rn-208,122,86,208,Rn,207.989635
Fr-208,121,87,208,Fr,207.997139
Ra-208,120,88,208,Ra,208.001855
Ac-208,119,89,208,Ac,208.011550
Th-208,118,90,208,Th,208.017920
Au-209,130,79,209,Au,208.997610
Hg-209,129,80,209,Hg,208.990760
Tl-209,128,81,209,Tl,208.985352
Pb-209,127,82,209,Pb,208.981090.0
Bi-209,126,83,209,Bi,208.980398.6
Po-209,125,84,209,Po,208.982430.4
At-209,124,85,209,At,208.986169
Rn-209,123,86,209,Rn,208.990401
Fr-209,122,87,209,Fr,208.995940
Ra-209,121,88,209,Ra,209.001995
Ac-209,120,89,209,Ac,209.009500
Th-209,119,90,209,Th,209.017600
Au-210,131,79,210,Au,210.002880
Hg-210,130,80,210,Hg,209.994310
Tl-210,129,81,210,Tl,209.990073
Pb-210,128,82,210,Pb,209.984188.4
Bi-210,127,83,210,Bi,209.984120.2
Po-210,126,84,210,Po,209.982873.7
At-210,125,85,210,At,209.987147
Rn-210,124,86,210,Rn,209.989689
Fr-210,123,87,210,Fr,209.996411
Ra-210,122,88,210,Ra,210.000475
Ac-210,121,89,210,Ac,210.009410
Th-210,120,90,210,Th,210.015094
Hg-211,131,80,211,Hg,210.999580
Tl-211,130,81,211,Tl,210.993480
Pb-211,129,82,211,Pb,210.988735.3
Bi-211,128,83,211,Bi,210.987269
Po-211,127,84,211,Po,210.986653.2
At-211,126,85,211,At,210.987496.2
Rn-211,125,86,211,Rn,210.990601
Fr-211,124,87,211,Fr,210.995555
Ra-211,123,88,211,Ra,211.000893
Ac-211,122,89,211,Ac,211.007670
Th-211,121,90,211,Th,211.014900
Pa-211,120,91,211,Pa,211.023670
Hg-212,132,80,212,Hg,212.003240
Tl-212,131,81,212,Tl,211.998340
Pb-212,130,82,212,Pb,211.991895.9
Bi-212,129,83,212,Bi,211.991285.0
Po-212,128,84,212,Po,211.988868.0
At-212,127,85,212,At,211.990737.3
Rn-212,126,86,212,Rn,211.990704
Fr-212,125,87,212,Fr,211.996225
Ra-212,124,88,212,Ra,211.999787
Ac-212,123,89,212,Ac,212.007836
Th-212,122,90,212,Th,212.013002
Pa-212,121,91,212,Pa,212.023180
Hg-213,133,80,213,Hg,213.008800
Tl-213,132,81,213,Tl,213.001915
Pb-213,131,82,213,Pb,212.996561
Bi-213,130,83,213,Bi,212.994384
Po-213,129,84,213,Po,212.992857
At-213,128,85,213,At,212.992937
Rn-213,127,86,213,Rn,212.993885
Fr-213,126,87,213,Fr,212.996184
Ra-213,125,88,213,Ra,213.000371
Ac-213,124,89,213,Ac,213.006593
Th-213,123,90,213,Th,213.013011
Pa-213,122,91,213,Pa,213.021100
Hg-214,134,80,214,Hg,214.012640
Tl-214,133,81,214,Tl,214.006940
Pb-214,132,82,214,Pb,213.999803.5
Bi-214,131,83,214,Bi,213.998711
Po-214,130,84,214,Po,213.995201.3
At-214,129,85,214,At,213.996372
Rn-214,128,86,214,Rn,213.995363
Fr-214,127,87,214,Fr,213.998971
Ra-214,126,88,214,Ra,214.000100
Ac-214,125,89,214,Ac,214.006906
Th-214,124,90,214,Th,214.011481
Pa-214,123,91,214,Pa,214.020890
Hg-215,135,80,215,Hg,215.018370
Tl-215,134,81,215,Tl,215.010770
Pb-215,133,82,215,Pb,215.004660
Bi-215,132,83,215,Bi,215.001749
Po-215,131,84,215,Po,214.999418.4
At-215,130,85,215,At,214.998651
Rn-215,129,86,215,Rn,214.998745
Fr-215,128,87,215,Fr,215.000342
Ra-215,127,88,215,Ra,215.002718
Ac-215,126,89,215,Ac,215.006474
Th-215,125,90,215,Th,215.011725
Pa-215,124,91,215,Pa,215.019110
U-215,123,92,215,U,215.026720
Hg-216,136,80,216,Hg,216.022460
Tl-216,135,81,216,Tl,216.015960
Pb-216,134,82,216,Pb,216.008060
Bi-216,133,83,216,Bi,216.006306
Po-216,132,84,216,Po,216.001913.4
At-216,131,85,216,At,216.002423
Rn-216,130,86,216,Rn,216.000272
Fr-216,129,87,216,Fr,216.003190
Ra-216,128,88,216,Ra,216.003534
Ac-216,127,89,216,Ac,216.008749
Th-216,126,90,216,Th,216.011056
Pa-216,125,91,216,Pa,216.019135
U-216,124,92,216,U,216.024760
Tl-217,136,81,217,Tl,217.020030
Pb-217,135,82,217,Pb,217.013160
Bi-217,134,83,217,Bi,217.009372
Po-217,133,84,217,Po,217.006316
At-217,132,85,217,At,217.004718
Rn-217,131,86,217,Rn,217.003928
Fr-217,130,87,217,Fr,217.004632
Ra-217,129,88,217,Ra,217.006323
Ac-217,128,89,217,Ac,217.009342
Th-217,127,90,217,Th,217.013103
Pa-217,126,91,217,Pa,217.018309
U-217,125,92,217,U,217.024660
Tl-218,137,81,218,Tl,218.025450
Pb-218,136,82,218,Pb,218.016780
Bi-218,135,83,218,Bi,218.014188
Po-218,134,84,218,Po,218.008971.2
At-218,133,85,218,At,218.008696
Rn-218,132,86,218,Rn,218.005601.1
Fr-218,131,87,218,Fr,218.007579
Ra-218,130,88,218,Ra,218.007134
Ac-218,129,89,218,Ac,218.011650
Th-218,128,90,218,Th,218.013276
Pa-218,127,91,218,Pa,218.020021
U-218,126,92,218,U,218.023505
Pb-219,137,82,219,Pb,219.022140
Bi-219,136,83,219,Bi,219.017520
Po-219,135,84,219,Po,219.013614
At-219,134,85,219,At,219.011161
Rn-219,133,86,219,Rn,219.009478.7
Fr-219,132,87,219,Fr,219.009251
Ra-219,131,88,219,Ra,219.010085
Ac-219,130,89,219,Ac,219.012420
Th-219,129,90,219,Th,219.015530
Pa-219,128,91,219,Pa,219.019950
U-219,127,92,219,U,219.025009
Np-219,126,93,219,Np,219.031600
Pb-220,138,82,220,Pb,220.025910
Bi-220,137,83,220,Bi,220.022500
Po-220,136,84,220,Po,220.016386
At-220,135,85,220,At,220.015433
Rn-220,134,86,220,Rn,220.011392.4
Fr-220,133,87,220,Fr,220.012327
Ra-220,132,88,220,Ra,220.011028
Ac-220,131,89,220,Ac,220.014755
Th-220,130,90,220,Th,220.015770
Pa-220,129,91,220,Pa,220.021770
U-220,128,92,220,U,220.024710
Np-220,127,93,220,Np,220.032720
Bi-221,138,83,221,Bi,221.025980
Po-221,137,84,221,Po,221.021228
At-221,136,85,221,At,221.018017
Rn-221,135,86,221,Rn,221.015536
Fr-221,134,87,221,Fr,221.014254
Ra-221,133,88,221,Ra,221.013917
Ac-221,132,89,221,Ac,221.015600
Th-221,131,90,221,Th,221.018186
Pa-221,130,91,221,Pa,221.021870
U-221,129,92,221,U,221.026320
Np-221,128,93,221,Np,221.032110
Pu-221,127,94,221,Pu,221.038570
Bi-222,139,83,222,Bi,222.031080
Po-222,138,84,222,Po,222.024140
At-222,137,85,222,At,222.022494
Rn-222,136,86,222,Rn,222.017576.0
Fr-222,135,87,222,Fr,222.017583
Ra-222,134,88,222,Ra,222.015373
Ac-222,133,89,222,Ac,222.017844
Th-222,132,90,222,Th,222.018468
Pa-222,131,91,222,Pa,222.023690
U-222,130,92,222,U,222.026060
Np-222,129,93,222,Np,222.033570
Pu-222,128,94,222,Pu,222.037640
Bi-223,140,83,223,Bi,223.034610
Po-223,139,84,223,Po,223.029070
At-223,138,85,223,At,223.025151
Rn-223,137,86,223,Rn,223.021889
Fr-223,136,87,223,Fr,223.019734.2
Ra-223,135,88,223,Ra,223.018500.6
Ac-223,134,89,223,Ac,223.019136
Th-223,133,90,223,Th,223.020811
Pa-223,132,91,223,Pa,223.023980
U-223,131,92,223,U,223.027960
Np-223,130,93,223,Np,223.032910
Pu-223,129,94,223,Pu,223.038780
Am-223,128,95,223,Am,223.045840
Bi-224,141,83,224,Bi,224.039800
Po-224,140,84,224,Po,224.032110
At-224,139,85,224,At,224.029749
Rn-224,138,86,224,Rn,224.024096
Fr-224,137,87,224,Fr,224.023348
Ra-224,136,88,224,Ra,224.020210.4
Ac-224,135,89,224,Ac,224.021722
Th-224,134,90,224,Th,224.021466
Pa-224,133,91,224,Pa,224.025617
U-224,132,92,224,U,224.027636
Np-224,131,93,224,Np,224.034390
Pu-224,130,94,224,Pu,224.037880
Am-224,129,95,224,Am,224.046440
Po-225,141,84,225,Po,225.037120
At-225,140,85,225,At,225.032530
Rn-225,139,86,225,Rn,225.028486
Fr-225,138,87,225,Fr,225.025572
Ra-225,137,88,225,Ra,225.023610.5
Ac-225,136,89,225,Ac,225.023229
Th-225,135,90,225,Th,225.023951
Pa-225,134,91,225,Pa,225.026150
U-225,133,92,225,U,225.029385
Np-225,132,93,225,Np,225.033940
Pu-225,131,94,225,Pu,225.038970
Am-225,130,95,225,Am,225.045510
Po-226,142,84,226,Po,226.040310
At-226,141,85,226,At,226.037210
Rn-226,140,86,226,Rn,226.030861
Fr-226,139,87,226,Fr,226.029545
Ra-226,138,88,226,Ra,226.025408.2
Ac-226,137,89,226,Ac,226.026097
Th-226,136,90,226,Th,226.024904
Pa-226,135,91,226,Pa,226.027948
U-226,134,92,226,U,226.029339
Np-226,133,93,226,Np,226.035230
Pu-226,132,94,226,Pu,226.038250
Am-226,131,95,226,Am,226.046130
Po-227,143,84,227,Po,227.045390
At-227,142,85,227,At,227.040180
Rn-227,141,86,227,Rn,227.035304
Fr-227,140,87,227,Fr,227.031865
Ra-227,139,88,227,Ra,227.029176.2
Ac-227,138,89,227,Ac,227.027750.6
Th-227,137,90,227,Th,227.027702.5
Pa-227,136,91,227,Pa,227.028804
U-227,135,92,227,U,227.031181
Np-227,134,93,227,Np,227.034980
Pu-227,133,94,227,Pu,227.039470
Am-227,132,95,227,Am,227.045280
At-228,143,85,228,At,228.044960
Rn-228,142,86,228,Rn,228.037835
Fr-228,141,87,228,Fr,228.035839
Ra-228,140,88,228,Ra,228.031068.6
Ac-228,139,89,228,Ac,228.031019.7
Th-228,138,90,228,Th,228.028739.7
Pa-228,137,91,228,Pa,228.031051
U-228,136,92,228,U,228.031369
Np-228,135,93,228,Np,228.036310
Pu-228,134,94,228,Pu,228.038763
Am-228,133,95,228,Am,228.046000
At-229,144,85,229,At,229.048190
Rn-229,143,86,229,Rn,229.042257
Fr-229,142,87,229,Fr,229.038291
Ra-229,141,88,229,Ra,229.034957
Ac-229,140,89,229,Ac,229.032947
Th-229,139,90,229,Th,229.031761.4
Pa-229,138,91,229,Pa,229.032096
U-229,137,92,229,U,229.033506
Np-229,136,93,229,Np,229.036290
Pu-229,135,94,229,Pu,229.040150
Am-229,134,95,229,Am,229.045280
Rn-230,144,86,230,Rn,230.045270
Fr-230,143,87,230,Fr,230.042391
Ra-230,142,88,230,Ra,230.037055
Ac-230,141,89,230,Ac,230.036327
Th-230,140,90,230,Th,230.033132.3
Pa-230,139,91,230,Pa,230.034540
U-230,138,92,230,U,230.033940
Np-230,137,93,230,Np,230.037830
Pu-230,136,94,230,Pu,230.039648
Am-230,135,95,230,Am,230.046030
Rn-231,145,86,231,Rn,231.049970
Fr-231,144,87,231,Fr,231.045175
Ra-231,143,88,231,Ra,231.041027
Ac-231,142,89,231,Ac,231.038393
Th-231,141,90,231,Th,231.036302.8
Pa-231,140,91,231,Pa,231.035882.5
U-231,139,92,231,U,231.036292.2
Np-231,138,93,231,Np,231.038240
Pu-231,137,94,231,Pu,231.041126
Am-231,136,95,231,Am,231.045530
Cm-231,135,96,231,Cm,231.050750
Fr-232,145,87,232,Fr,232.049461
Ra-232,144,88,232,Ra,232.043475
Ac-232,143,89,232,Ac,232.042034
Th-232,142,90,232,Th,232.038053.6
Pa-232,141,91,232,Pa,232.038590
U-232,140,92,232,U,232.037154.8
Np-232,139,93,232,Np,232.040110
Pu-232,138,94,232,Pu,232.041182
Am-232,137,95,232,Am,232.046610
Cm-232,136,96,232,Cm,232.049740
Fr-233,146,87,233,Fr,233.052518
Ra-233,145,88,233,Ra,233.047595
Ac-233,144,89,233,Ac,233.044346
Th-233,143,90,233,Th,233.041580.1
Pa-233,142,91,233,Pa,233.040246.5
U-233,141,92,233,U,233.039634.3
Np-233,140,93,233,Np,233.040740
Pu-233,139,94,233,Pu,233.043000
Am-233,138,95,233,Am,233.046470
Cm-233,137,96,233,Cm,233.050770
Bk-233,136,97,233,Bk,233.056650
Ra-234,146,88,234,Ra,234.050382
Ac-234,145,89,234,Ac,234.048139
Th-234,144,90,234,Th,234.043599.8
Pa-234,143,91,234,Pa,234.043306
U-234,142,92,234,U,234.040950.3
Np-234,141,93,234,Np,234.042893
Pu-234,140,94,234,Pu,234.043317
Am-234,139,95,234,Am,234.047730
Cm-234,138,96,234,Cm,234.050159
Bk-234,137,97,234,Bk,234.057320
Ra-235,147,88,235,Ra,235.054890
Ac-235,146,89,235,Ac,235.050840
Th-235,145,90,235,Th,235.047255
Pa-235,144,91,235,Pa,235.045399
U-235,143,92,235,U,235.043928.1
Np-235,142,93,235,Np,235.044061.5
Pu-235,141,94,235,Pu,235.045285
Am-235,140,95,235,Am,235.047910
Cm-235,139,96,235,Cm,235.051550
Bk-235,138,97,235,Bk,235.056650
Ac-236,147,89,236,Ac,236.054990
Th-236,146,90,236,Th,236.049657
Pa-236,145,91,236,Pa,236.048668
U-236,144,92,236,U,236.045566.1
Np-236,143,93,236,Np,236.046570
Pu-236,142,94,236,Pu,236.046056.7
Am-236,141,95,236,Am,236.049430
Cm-236,140,96,236,Cm,236.051372
Bk-236,139,97,236,Bk,236.057480
Ac-237,148,89,237,Ac,237.057990
Th-237,147,90,237,Th,237.053629
Pa-237,146,91,237,Pa,237.051023
U-237,145,92,237,U,237.048728.3
Np-237,144,93,237,Np,237.048171.6
Pu-237,143,94,237,Pu,237.048407.9
Am-237,142,95,237,Am,237.050000
Cm-237,141,96,237,Cm,237.052870
Bk-237,140,97,237,Bk,237.057120
Cf-237,139,98,237,Cf,237.062200
Th-238,148,90,238,Th,238.056390
Pa-238,147,91,238,Pa,238.054637
U-238,146,92,238,U,238.050786.9
Np-238,145,93,238,Np,238.050944.6
Pu-238,144,94,238,Pu,238.049558.2
Am-238,143,95,238,Am,238.051980
Cm-238,142,96,238,Cm,238.053082
Bk-238,141,97,238,Bk,238.058200
Cf-238,140,98,238,Cf,238.061490
Th-239,149,90,239,Th,239.060660
Pa-239,148,91,239,Pa,239.057260
U-239,147,92,239,U,239.054292.0
Np-239,146,93,239,Np,239.052937.5
Pu-239,145,94,239,Pu,239.052161.6
Am-239,144,95,239,Am,239.053022.7
Cm-239,143,96,239,Cm,239.054910
Bk-239,142,97,239,Bk,239.058240
Cf-239,141,98,239,Cf,239.062480
Es-239,140,99,239,Es,239.068310
Pa-240,149,91,240,Pa,240.061200
U-240,148,92,240,U,240.056592.4
Np-240,147,93,240,Np,240.056164
Pu-240,146,94,240,Pu,240.053811.7
Am-240,145,95,240,Am,240.055298
Cm-240,144,96,240,Cm,240.055528.2
Bk-240,143,97,240,Bk,240.059760
Cf-240,142,98,240,Cf,240.062253
Es-240,141,99,240,Es,240.068950
Pa-241,150,91,241,Pa,241.064130
U-241,149,92,241,U,241.060330
Np-241,148,93,241,Np,241.058310
Pu-241,147,94,241,Pu,241.056849.7
Am-241,146,95,241,Am,241.056827.3
Cm-241,145,96,241,Cm,241.057651.2
Bk-241,144,97,241,Bk,241.060100
Cf-241,143,98,241,Cf,241.063690
Es-241,142,99,241,Es,241.068590
Fm-241,141,100,241,Fm,241.074310
U-242,150,92,242,U,242.062930
Np-242,149,93,242,Np,242.061640
Pu-242,148,94,242,Pu,242.058741.0
Am-242,147,95,242,Am,242.059547.4
Cm-242,146,96,242,Cm,242.058834.2
Bk-242,145,97,242,Bk,242.062000
Cf-242,144,98,242,Cf,242.063755
Es-242,143,99,242,Es,242.069570
Fm-242,142,100,242,Fm,242.073430
U-243,151,92,243,U,243.067080
Np-243,150,93,243,Np,243.064200
Pu-243,149,94,243,Pu,243.062002.1
Am-243,148,95,243,Am,243.061379.9
Cm-243,147,96,243,Cm,243.061387.3
Bk-243,146,97,243,Bk,243.063006
Cf-243,145,98,243,Cf,243.065480
Es-243,144,99,243,Es,243.069510
Fm-243,143,100,243,Fm,243.074410
Np-244,151,93,244,Np,244.067890
Pu-244,150,94,244,Pu,244.064204.4
Am-244,149,95,244,Am,244.064282.9
Cm-244,148,96,244,Cm,244.062750.6
Bk-244,147,97,244,Bk,244.065179
Cf-244,146,98,244,Cf,244.065999.4
Es-244,145,99,244,Es,244.070880
Fm-244,144,100,244,Fm,244.074040
Md-244,143,101,244,Md,244.081160
Np-245,152,93,245,Np,245.070690
Pu-245,151,94,245,Pu,245.067825
Am-245,150,95,245,Am,245.066452.8
Cm-245,149,96,245,Cm,245.065491.0
Bk-245,148,97,245,Bk,245.066359.8
Cf-245,147,98,245,Cf,245.068046.8
Es-245,146,99,245,Es,245.071190
Fm-245,145,100,245,Fm,245.075350
Md-245,144,101,245,Md,245.080860
Pu-246,152,94,246,Pu,246.070204
Am-246,151,95,246,Am,246.069774
Cm-246,150,96,246,Cm,246.067222.0
Bk-246,149,97,246,Bk,246.068670
Cf-246,148,98,246,Cf,246.068803.7
Es-246,147,99,246,Es,246.072810
Fm-246,146,100,246,Fm,246.075353
Md-246,145,101,246,Md,246.081710
Pu-247,153,94,247,Pu,247.074300
Am-247,152,95,247,Am,247.072090
Cm-247,151,96,247,Cm,247.070353
Bk-247,150,97,247,Bk,247.070306
Cf-247,149,98,247,Cf,247.070971
Es-247,148,99,247,Es,247.073622
Fm-247,147,100,247,Fm,247.076940
Md-247,146,101,247,Md,247.081520
Am-248,153,95,248,Am,248.075750
Cm-248,152,96,248,Cm,248.072349.1
Bk-248,151,97,248,Bk,248.073140
Cf-248,150,98,248,Cf,248.072183
Es-248,149,99,248,Es,248.075470
Fm-248,148,100,248,Fm,248.077185
Md-248,147,101,248,Md,248.082610
No-248,146,102,248,No,248.086620
Am-249,154,95,249,Am,249.078480
Cm-249,153,96,249,Cm,249.075954.0
Bk-249,152,97,249,Bk,249.074983.1
Cf-249,151,98,249,Cf,249.074850.4
Es-249,150,99,249,Es,249.076410
Fm-249,149,100,249,Fm,249.078926
Md-249,148,101,249,Md,249.082860
No-249,147,102,249,No,249.087800
Cm-250,154,96,250,Cm,250.078358
Bk-250,153,97,250,Bk,250.078317
Cf-250,152,98,250,Cf,250.076404.5
Es-250,151,99,250,Es,250.078610
Fm-250,150,100,250,Fm,250.079520
Md-250,149,101,250,Md,250.084160
No-250,148,102,250,No,250.087570
Cm-251,155,96,251,Cm,251.082285
Bk-251,154,97,251,Bk,251.080761
Cf-251,153,98,251,Cf,251.079587
Es-251,152,99,251,Es,251.079991
Fm-251,151,100,251,Fm,251.081545
Md-251,150,101,251,Md,251.084774
No-251,149,102,251,No,251.088940
Lr-251,148,103,251,Lr,251.094290
Cm-252,156,96,252,Cm,252.084870
Bk-252,155,97,252,Bk,252.084310
Cf-252,154,98,252,Cf,252.081626.5
Es-252,153,99,252,Es,252.082980
Fm-252,152,100,252,Fm,252.082466
Md-252,151,101,252,Md,252.086390
No-252,150,102,252,No,252.088966
Lr-252,149,103,252,Lr,252.095050
Bk-253,156,97,253,Bk,253.086880
Cf-253,155,98,253,Cf,253.085134
Es-253,154,99,253,Es,253.084821.2
Fm-253,153,100,253,Fm,253.085180.9
Md-253,152,101,253,Md,253.087140
No-253,151,102,253,No,253.090563
Lr-253,150,103,253,Lr,253.095030
Rf-253,149,104,253,Rf,253.100530
Bk-254,157,97,254,Bk,254.090600
Cf-254,156,98,254,Cf,254.087324
Es-254,155,99,254,Es,254.088024
Fm-254,154,100,254,Fm,254.086852.4
Md-254,153,101,254,Md,254.089590
No-254,152,102,254,No,254.090954
Lr-254,151,103,254,Lr,254.096240
Rf-254,150,104,254,Rf,254.100060
Cf-255,157,98,255,Cf,255.091050
Es-255,156,99,255,Es,255.090274
Fm-255,155,100,255,Fm,255.089963
Md-255,154,101,255,Md,255.091082
No-255,153,102,255,No,255.093196
Lr-255,152,103,255,Lr,255.096562
Rf-255,151,104,255,Rf,255.101270
Db-255,150,105,255,Db,255.106920
Cf-256,158,98,256,Cf,256.093440
Es-256,157,99,256,Es,256.093600
Fm-256,156,100,256,Fm,256.091772
Md-256,155,101,256,Md,256.093890
No-256,154,102,256,No,256.094282
Lr-256,153,103,256,Lr,256.098490
Rf-256,152,104,256,Rf,256.101151
Db-256,151,105,256,Db,256.107670
Es-257,158,99,257,Es,257.095980
Fm-257,157,100,257,Fm,257.095105
Md-257,156,101,257,Md,257.095537.3
No-257,155,102,257,No,257.096884
Lr-257,154,103,257,Lr,257.099480
Rf-257,153,104,257,Rf,257.102917
Db-257,152,105,257,Db,257.107520
Es-258,159,99,258,Es,258.099520
Fm-258,158,100,258,Fm,258.097080
Md-258,157,101,258,Md,258.098434
No-258,156,102,258,No,258.098210
Lr-258,155,103,258,Lr,258.101750
Rf-258,154,104,258,Rf,258.103430
Db-258,153,105,258,Db,258.108970
Sg-258,152,106,258,Sg,258.113040
Fm-259,159,100,259,Fm,259.100600
Md-259,158,101,259,Md,259.100450
No-259,157,102,259,No,259.100998
Lr-259,156,103,259,Lr,259.102900
Rf-259,155,104,259,Rf,259.105600
Db-259,154,105,259,Db,259.109490
Sg-259,153,106,259,Sg,259.114350
Fm-260,160,100,260,Fm,260.102810
Md-260,159,101,260,Md,260.103650
No-260,158,102,260,No,260.102640
Lr-260,157,103,260,Lr,260.105500
Rf-260,156,104,260,Rf,260.106440
Db-260,155,105,260,Db,260.111300
Sg-260,154,106,260,Sg,260.114383
Bh-260,153,107,260,Bh,260.121440
Md-261,160,101,261,Md,261.105830
No-261,159,102,261,No,261.105700
Lr-261,158,103,261,Lr,261.106880
Rf-261,157,104,261,Rf,261.108770
Db-261,156,105,261,Db,261.111980
Sg-261,155,106,261,Sg,261.115948
Bh-261,154,107,261,Bh,261.121400
Md-262,161,101,262,Md,262.109140
No-262,160,102,262,No,262.107460
Lr-262,159,103,262,Lr,262.109620
Rf-262,158,104,262,Rf,262.109920
Db-262,157,105,262,Db,262.114070
Sg-262,156,106,262,Sg,262.116339
Bh-262,155,107,262,Bh,262.122650
No-263,161,102,263,No,263.110710
Lr-263,160,103,263,Lr,263.111290
Rf-263,159,104,263,Rf,263.112460
Db-263,158,105,263,Db,263.114990
Sg-263,157,106,263,Sg,263.118300
Bh-263,156,107,263,Bh,263.122920
Hs-263,155,108,263,Hs,263.128480
No-264,162,102,264,No,264.112730
Lr-264,161,103,264,Lr,264.114200
Rf-264,160,104,264,Rf,264.113880
Db-264,159,105,264,Db,264.117300
Sg-264,158,106,264,Sg,264.118930
Bh-264,157,107,264,Bh,264.124490
Hs-264,156,108,264,Hs,264.128360
Lr-265,162,103,265,Lr,265.116190
Rf-265,161,104,265,Rf,265.116680
Db-265,160,105,265,Db,265.118500
Sg-265,159,106,265,Sg,265.121090
Bh-265,158,107,265,Bh,265.124960
Hs-265,157,108,265,Hs,265.129792
Mt-265,156,109,265,Mt,265.135940
Lr-266,163,103,266,Lr,266.119870
Rf-266,162,104,266,Rf,266.118240
Db-266,161,105,266,Db,266.121030
Sg-266,160,106,266,Sg,266.121970
Bh-266,159,107,266,Bh,266.126790
Hs-266,158,108,266,Hs,266.130049
Mt-266,157,109,266,Mt,266.137060
Rf-267,163,104,267,Rf,267.121790
Db-267,162,105,267,Db,267.122400
Sg-267,161,106,267,Sg,267.124320
Bh-267,160,107,267,Bh,267.127500
Hs-267,159,108,267,Hs,267.131680
Mt-267,158,109,267,Mt,267.137190
Ds-267,157,110,267,Ds,267.143730
Rf-268,164,104,268,Rf,268.123970
Db-268,163,105,268,Db,268.125670
Sg-268,162,106,268,Sg,268.125390
Bh-268,161,107,268,Bh,268.129580
Hs-268,160,108,268,Hs,268.132010
Mt-268,159,109,268,Mt,268.138650
Ds-268,158,110,268,Ds,268.143480
Db-269,164,105,269,Db,269.127910
Sg-269,163,106,269,Sg,269.128500
Bh-269,162,107,269,Bh,269.130410
Hs-269,161,108,269,Hs,269.133650
Mt-269,160,109,269,Mt,269.138810
Ds-269,159,110,269,Ds,269.144750
Db-270,165,105,270,Db,270.131400
Sg-270,164,106,270,Sg,270.130360
Bh-270,163,107,270,Bh,270.133370
Hs-270,162,108,270,Hs,270.134310
Mt-270,161,109,270,Mt,270.140320
Ds-270,160,110,270,Ds,270.144590
Sg-271,165,106,271,Sg,271.133780
Bh-271,164,107,271,Bh,271.135120
Hs-271,163,108,271,Hs,271.137080
Mt-271,162,109,271,Mt,271.140740
Ds-271,161,110,271,Ds,271.145950
Sg-272,166,106,272,Sg,272.135830
Bh-272,165,107,272,Bh,272.138260
Hs-272,164,108,272,Hs,272.138490
Mt-272,163,109,272,Mt,272.143300
Ds-272,162,110,272,Ds,272.146090
Rg-272,161,111,272,Rg,272.153270
Sg-273,167,106,273,Sg,273.139480
Bh-273,166,107,273,Bh,273.140290
Hs-273,165,108,273,Hs,273.141460
Mt-273,164,109,273,Mt,273.144700
Ds-273,163,110,273,Ds,273.148460
Rg-273,162,111,273,Rg,273.153390
Bh-274,167,107,274,Bh,274.143600
Hs-274,166,108,274,Hs,274.143220
Mt-274,165,109,274,Mt,274.147340
Ds-274,164,110,274,Ds,274.149430
Rg-274,163,111,274,Rg,274.155250
Bh-275,168,107,275,Bh,275.145770
Hs-275,167,108,275,Hs,275.146530
Mt-275,166,109,275,Mt,275.148970
Ds-275,165,110,275,Ds,275.152090
Rg-275,164,111,275,Rg,275.156090
Bh-276,169,107,276,Bh,276.149170
Hs-276,168,108,276,Hs,276.148350
Mt-276,167,109,276,Mt,276.151710
Ds-276,166,110,276,Ds,276.153020
Rg-276,165,111,276,Rg,276.158230
Cn-276,164,112,276,Cn,276.161420
Bh-277,170,107,277,Bh,277.151480
Hs-277,169,108,277,Hs,277.151770
Mt-277,168,109,277,Mt,277.153530
Ds-277,167,110,277,Ds,277.155760
Rg-277,166,111,277,Rg,277.159320
Cn-277,165,112,277,Cn,277.163540
Bh-278,171,107,278,Bh,278.154990
Hs-278,170,108,278,Hs,278.153750
Mt-278,169,109,278,Mt,278.156490
Ds-278,168,110,278,Ds,278.157010
Rg-278,167,111,278,Rg,278.161590
Cn-278,166,112,278,Cn,278.164080
Nh-278,165,113,278,Nh,278.170730
Hs-279,171,108,279,Hs,279.157270
Mt-279,170,109,279,Mt,279.158440
Ds-279,169,110,279,Ds,279.159980
Rg-279,168,111,279,Rg,279.162880
Cn-279,167,112,279,Cn,279.166420
Nh-279,166,113,279,Nh,279.171190
Hs-280,172,108,280,Hs,280.159340
Mt-280,171,109,280,Mt,280.161580
Ds-280,170,110,280,Ds,280.161380
Rg-280,169,111,280,Rg,280.165200
Cn-280,168,112,280,Cn,280.167100
Nh-280,167,113,280,Nh,280.173100
Mt-281,172,109,281,Mt,281.163610
Ds-281,171,110,281,Ds,281.164550
Rg-281,170,111,281,Rg,281.166760
Cn-281,169,112,281,Cn,281.169560
Nh-281,168,113,281,Nh,281.173710
Mt-282,173,109,282,Mt,282.166890
Ds-282,172,110,282,Ds,282.166170
Rg-282,171,111,282,Rg,282.169340
Cn-282,170,112,282,Cn,282.170510
Nh-282,169,113,282,Nh,282.175770
Ds-283,173,110,283,Ds,283.169440
Rg-283,172,111,283,Rg,283.171100
Cn-283,171,112,283,Cn,283.173200
Nh-283,170,113,283,Nh,283.176670
Ds-284,174,110,284,Ds,284.171190
Rg-284,173,111,284,Rg,284.173880
Cn-284,172,112,284,Cn,284.174360
Nh-284,171,113,284,Nh,284.178840
Fl-284,170,114,284,Fl,284.181190
Rg-285,174,111,285,Rg,285.175770
Cn-285,173,112,285,Cn,285.177230
Nh-285,172,113,285,Nh,285.180110
Fl-285,171,114,285,Fl,285.183500
Rg-286,175,111,286,Rg,286.178760
Cn-286,174,112,286,Cn,286.178690
Nh-286,173,113,286,Nh,286.182460
Fl-286,172,114,286,Fl,286.184230
Cn-287,175,112,287,Cn,287.181830
Nh-287,174,113,287,Nh,287.184060
Fl-287,173,114,287,Fl,287.186720
Mc-287,172,115,287,Mc,287.190820
Cn-288,176,112,288,Cn,288.183500
Nh-288,175,113,288,Nh,288.186760
Fl-288,174,114,288,Fl,288.187780
Mc-288,173,115,288,Mc,288.192880
Nh-289,176,113,289,Nh,289.188460
Fl-289,175,114,289,Fl,289.190520
Mc-289,174,115,289,Mc,289.193970
Lv-289,173,116,289,Lv,289.198020
Nh-290,177,113,290,Nh,290.191430
Fl-290,176,114,290,Fl,290.191880
Mc-290,175,115,290,Mc,290.196240
Lv-290,174,116,290,Lv,290.198640
Fl-291,177,114,291,Fl,291.194850
Mc-291,176,115,291,Mc,291.197730
Lv-291,175,116,291,Lv,291.201010
Ts-291,174,117,291,Ts,291.205750
Mc-292,177,115,292,Mc,292.200320
Lv-292,176,116,292,Lv,292.201970
Ts-292,175,117,292,Ts,292.207860
Lv-293,177,116,293,Lv,293.204580
Ts-293,176,117,293,Ts,293.208730
Og-293,175,118,293,Og,293.213420
Ts-294,177,117,294,Ts,294.210840
Og-294,176,118,294,Og,294.213980
Og-295,177,118,295,Og,295.216180
